State_ab,county,Labor Force,Employed,Unemployed,Unemployment Rate (%)
AL,Autauga,26405,24985,1420,5.40
AL,Baldwin,98910,92751,6159,6.20
AL,Barbour,8680,8004,676,7.80
AL,Bibb,8712,8073,639,7.30
AL,Blount,25116,23973,1143,4.60
AL,Bullock,4877,4582,295,6.00
AL,Butler,9236,8345,891,9.60
AL,Calhoun,47022,43367,3655,7.80
AL,Chambers,16093,14884,1209,7.50
AL,Cherokee,11672,11073,599,5.10
AL,Chilton,19936,18839,1097,5.50
AL,Choctaw,4699,4351,348,7.40
AL,Clarke,7899,7116,783,9.90
AL,Clay,6140,5865,275,4.50
AL,Cleburne,5852,5556,296,5.10
AL,Coffee,22008,20938,1070,4.90
AL,Colbert,23895,22152,1743,7.30
AL,Conecuh,4582,4214,368,8.00
AL,Coosa,4428,4156,272,6.10
AL,Covington,15342,14500,842,5.50
AL,Crenshaw,6371,5971,400,6.30
AL,Cullman,38862,36992,1870,4.80
AL,Dale,20928,19793,1135,5.40
AL,Dallas,14836,13091,1745,11.80
AL,DeKalb,31289,29721,1568,5.00
AL,Elmore,37662,35657,2005,5.30
AL,Escambia,14604,13611,993,6.80
AL,Etowah,41417,37912,3505,8.50
AL,Fayette,6664,6294,370,5.60
AL,Franklin,14567,13844,723,5.00
AL,Geneva,11029,10520,509,4.60
AL,Greene,3094,2728,366,11.80
AL,Hale,6165,5529,636,10.30
AL,Henry,6909,6535,374,5.40
AL,Houston,47221,44396,2825,6.00
AL,Jackson,23091,21727,1364,5.90
AL,Jefferson,320394,298447,21947,6.90
AL,Lamar,5788,5474,314,5.40
AL,Lauderdale,42649,40026,2623,6.20
AL,Lawrence,14528,13736,792,5.50
AL,Lee,76533,72090,4443,5.80
AL,Limestone,45890,43726,2164,4.70
AL,Lowndes,3723,3182,541,14.50
AL,Macon,8186,7327,859,10.50
AL,Madison,189632,179871,9761,5.10
AL,Marengo,7864,7319,545,6.90
AL,Marion,13291,12545,746,5.60
AL,Marshall,44783,42700,2083,4.70
AL,Mobile,195089,178158,16931,8.70
AL,Monroe,7626,6943,683,9.00
AL,Montgomery,108329,99047,9282,8.60
AL,Morgan,59737,56771,2966,5.00
AL,Perry,3452,3038,414,12.00
AL,Pickens,7688,7128,560,7.30
AL,Pike,15841,14976,865,5.50
AL,Randolph,9570,9063,507,5.30
AL,Russell,23819,22447,1372,5.80
AL,St. Clair,41389,39149,2240,5.40
AL,Shelby,117880,112894,4986,4.20
AL,Sumter,4780,4410,370,7.70
AL,Talladega,36433,33605,2828,7.80
AL,Tallapoosa,18204,16822,1382,7.60
AL,Tuscaloosa,103776,96225,7551,7.30
AL,Walker,25210,23583,1627,6.50
AL,Washington,6823,6219,604,8.90
AL,Wilcox,2921,2449,472,16.20
AL,Winston,10271,9734,537,5.20
AK,Aleutians East Borough,2515,2411,104,4.10
AK,Aleutians West Census Area,3835,3655,180,4.70
AK,Anchorage Borough/municipality,147223,135682,11541,7.80
AK,Bethel Census Area,6987,6136,851,12.20
AK,Bristol Bay Borough,393,362,31,7.90
AK,Chugach Census Area,3251,2972,279,8.60
AK,Copper River Census Area,1290,1153,137,10.60
AK,Denali Borough,645,534,111,17.20
AK,Dillingham Census Area,1721,1570,151,8.80
AK,Fairbanks North Star Borough,44597,41628,2969,6.70
AK,Haines Borough,1021,854,167,16.40
AK,Hoonah-Angoon Census Area,1055,908,147,13.90
AK,Juneau Borough/city,16306,15168,1138,7.00
AK,Kenai Peninsula Borough,26625,24098,2527,9.50
AK,Ketchikan Gateway Borough,6481,5823,658,10.20
AK,Kodiak Island Borough,6068,5666,402,6.60
AK,Kusilvak Census Area,2288,1817,471,20.60
AK,Lake and Peninsula Borough,613,543,70,11.40
AK,Matanuska-Susitna Borough,48388,44183,4205,8.70
AK,Nome Census Area,3939,3508,431,10.90
AK,North Slope Borough,3164,2971,193,6.10
AK,Northwest Arctic Borough,2941,2570,371,12.60
AK,Petersburg Borough,1430,1301,129,9.00
AK,Prince of Wales-Hyder Census Area,2833,2558,275,9.70
AK,Sitka Borough/city,4121,3822,299,7.30
AK,Skagway Municipality,641,503,138,21.50
AK,Southeast Fairbanks Census Area,2945,2719,226,7.70
AK,Wrangell Borough/city,955,867,88,9.20
AK,Yakutat Borough/city,279,255,24,8.60
AK,Yukon-Koyukuk Census Area,2334,2041,293,12.60
AZ,Apache,19502,17058,2444,12.50
AZ,Cochise,50090,46659,3431,6.80
AZ,Coconino,72016,65193,6823,9.50
AZ,Gila,20355,18830,1525,7.50
AZ,Graham,15412,14464,948,6.20
AZ,Greenlee,4307,4082,225,5.20
AZ,La Paz,8726,8117,609,7.00
AZ,Maricopa,2256967,2094758,162209,7.20
AZ,Mohave,85930,77556,8374,9.70
AZ,Navajo,39186,35304,3882,9.90
AZ,Pima,479345,443416,35929,7.50
AZ,Pinal,187999,174319,13680,7.30
AZ,Santa Cruz,18775,16677,2098,11.20
AZ,Yavapai,103471,95949,7522,7.30
AZ,Yuma,94768,78717,16051,16.90
AR,Arkansas,9436,9058,378,4.00
AR,Ashley,7178,6506,672,9.40
AR,Baxter,16576,15584,992,6.00
AR,Benton,141515,135182,6333,4.50
AR,Boone,15857,15019,838,5.30
AR,Bradley,4368,4110,258,5.90
AR,Calhoun,2416,2289,127,5.30
AR,Carroll,12735,12013,722,5.70
AR,Chicot,3213,2876,337,10.50
AR,Clark,9263,8711,552,6.00
AR,Clay,5546,5209,337,6.10
AR,Cleburne,9190,8489,701,7.60
AR,Cleveland,3252,3055,197,6.10
AR,Columbia,9058,8437,621,6.90
AR,Conway,8413,7903,510,6.10
AR,Craighead,56309,53304,3005,5.30
AR,Crawford,26510,25062,1448,5.50
AR,Crittenden,21102,19339,1763,8.40
AR,Cross,7264,6820,444,6.10
AR,Dallas,2821,2669,152,5.40
AR,Desha,5289,4916,373,7.10
AR,Drew,7716,7180,536,6.90
AR,Faulkner,62006,58616,3390,5.50
AR,Franklin,7481,7058,423,5.70
AR,Fulton,4929,4675,254,5.20
AR,Garland,41320,38009,3311,8.00
AR,Grant,8289,7858,431,5.20
AR,Greene,19601,18430,1171,6.00
AR,Hempstead,9628,9125,503,5.20
AR,Hot Spring,14075,13256,819,5.80
AR,Howard,5553,5273,280,5.00
AR,Independence,16737,15770,967,5.80
AR,Izard,4655,4261,394,8.50
AR,Jackson,5852,5428,424,7.20
AR,Jefferson,27287,25079,2208,8.10
AR,Johnson,10140,9498,642,6.30
AR,Lafayette,2419,2233,186,7.70
AR,Lawrence,6797,6377,420,6.20
AR,Lee,2747,2536,211,7.70
AR,Lincoln,3868,3637,231,6.00
AR,Little River,5353,5003,350,6.50
AR,Logan,8664,8085,579,6.70
AR,Lonoke,33761,31886,1875,5.60
AR,Madison,7292,7001,291,4.00
AR,Marion,6265,5860,405,6.50
AR,Miller,19343,18003,1340,6.90
AR,Mississippi,17269,15704,1565,9.10
AR,Monroe,2722,2541,181,6.60
AR,Montgomery,2958,2752,206,7.00
AR,Nevada,3545,3336,209,5.90
AR,Newton,3186,3023,163,5.10
AR,Ouachita,9840,9243,597,6.10
AR,Perry,4132,3899,233,5.60
AR,Phillips,6303,5723,580,9.20
AR,Pike,4270,4016,254,5.90
AR,Poinsett,9753,9206,547,5.60
AR,Polk,8005,7468,537,6.70
AR,Pope,27870,26218,1652,5.90
AR,Prairie,3611,3417,194,5.40
AR,Pulaski,189050,174991,14059,7.40
AR,Randolph,7449,7006,443,5.90
AR,St. Francis,8022,7388,634,7.90
AR,Saline,58783,55813,2970,5.10
AR,Scott,4345,4150,195,4.50
AR,Searcy,2878,2692,186,6.50
AR,Sebastian,56085,52716,3369,6.00
AR,Sevier,5543,5218,325,5.90
AR,Sharp,5717,5306,411,7.20
AR,Stone,4624,4295,329,7.10
AR,Union,15615,14310,1305,8.40
AR,Van Buren,5767,5354,413,7.20
AR,Washington,125379,119532,5847,4.70
AR,White,34020,31880,2140,6.30
AR,Woodruff,2826,2661,165,5.80
AR,Yell,7933,7526,407,5.10
CA,Alameda,816829,743193,73636,9.00
CA,Alpine,513,453,60,11.70
CA,Amador,14451,13084,1367,9.50
CA,Butte,93080,84291,8789,9.40
CA,Calaveras,21315,19637,1678,7.90
CA,Colusa,10607,8853,1754,16.50
CA,Contra Costa,545458,495891,49567,9.10
CA,Del Norte,9414,8497,917,9.70
CA,El Dorado,90730,82984,7746,8.50
CA,Fresno,444993,392711,52282,11.70
CA,Glenn,12737,11581,1156,9.10
CA,Humboldt,59653,54515,5138,8.60
CA,Imperial,71528,55218,16310,22.80
CA,Inyo,8305,7637,668,8.00
CA,Kern,385860,335929,49931,12.90
CA,Kings,56921,50118,6803,12.00
CA,Lake,28411,25614,2797,9.80
CA,Lassen,9393,8694,699,7.40
CA,Los Angeles,4960339,4350509,609830,12.30
CA,Madera,61852,54920,6932,11.20
CA,Marin,130414,121476,8938,6.90
CA,Mariposa,7191,6385,806,11.20
CA,Mendocino,37099,33698,3401,9.20
CA,Merced,115332,100761,14571,12.60
CA,Modoc,3174,2893,281,8.90
CA,Mono,7875,6917,958,12.20
CA,Monterey,213837,189830,24007,11.20
CA,Napa,68777,62575,6202,9.00
CA,Nevada,46697,42871,3826,8.20
CA,Orange,1561462,1420678,140784,9.00
CA,Placer,186664,172621,14043,7.50
CA,Plumas,7615,6768,847,11.10
CA,Riverside,1117258,1003553,113705,10.20
CA,Sacramento,709713,641956,67757,9.50
CA,San Benito,32493,29251,3242,10.00
CA,San Bernardino,971384,876969,94415,9.70
CA,San Diego,1541979,1395730,146249,9.50
CA,San Francisco/city,558105,513363,44742,8.00
CA,San Joaquin,334292,295559,38733,11.60
CA,San Luis Obispo,133921,123379,10542,7.90
CA,San Mateo,437835,407241,30594,7.00
CA,Santa Barbara,218122,200213,17909,8.20
CA,Santa Clara,1021799,948273,73526,7.20
CA,Santa Cruz,134611,121436,13175,9.80
CA,Shasta,73129,66563,6566,9.00
CA,Sierra,1283,1176,107,8.30
CA,Siskiyou,16938,15228,1710,10.10
CA,Solano,201518,181675,19843,9.80
CA,Sonoma,245312,225417,19895,8.10
CA,Stanislaus,241656,214903,26753,11.10
CA,Sutter,45440,40238,5202,11.40
CA,Tehama,25630,23282,2348,9.20
CA,Trinity,4532,4157,375,8.30
CA,Tulare,202207,174781,27426,13.60
CA,Tuolumne,20153,17998,2155,10.70
CA,Ventura,409408,373303,36105,8.80
CA,Yolo,104638,96435,8203,7.80
CA,Yuba,30665,27370,3295,10.70
CO,Adams,270349,249734,20615,7.60
CO,Alamosa,8312,7809,503,6.10
CO,Arapahoe,359977,333136,26841,7.50
CO,Archuleta,7042,6537,505,7.20
CO,Baca,2083,2036,47,2.30
CO,Bent,1773,1700,73,4.10
CO,Boulder,190742,179615,11127,5.80
CO,Broomfield/city,40409,37908,2501,6.20
CO,Chaffee,9642,9062,580,6.00
CO,Cheyenne,1083,1058,25,2.30
CO,Clear Creek,5964,5475,489,8.20
CO,Conejos,4006,3790,216,5.40
CO,Costilla,1812,1687,125,6.90
CO,Crowley,1440,1364,76,5.30
CO,Custer,2085,1986,99,4.70
CO,Delta,14159,13273,886,6.30
CO,Denver/city,419844,387275,32569,7.80
CO,Dolores,1135,1061,74,6.50
CO,Douglas,196099,185505,10594,5.40
CO,Eagle,35383,32204,3179,9.00
CO,Elbert,15000,14339,661,4.40
CO,El Paso,341997,318462,23535,6.90
CO,Fremont,15223,14104,1119,7.40
CO,Garfield,31405,29376,2029,6.50
CO,Gilpin,3930,3501,429,10.90
CO,Grand,9245,8505,740,8.00
CO,Gunnison,11296,10587,709,6.30
CO,Hinsdale,423,406,17,4.00
CO,Huerfano,2597,2362,235,9.00
CO,Jackson,935,898,37,4.00
CO,Jefferson,327550,305440,22110,6.80
CO,Kiowa,953,931,22,2.30
CO,Kit Carson,4211,4098,113,2.70
CO,Lake,4803,4434,369,7.70
CO,La Plata,30924,28897,2027,6.60
CO,Larimer,201273,189216,12057,6.00
CO,Las Animas,6398,5947,451,7.00
CO,Lincoln,2340,2241,99,4.20
CO,Logan,10867,10385,482,4.40
CO,Mesa,74725,69424,5301,7.10
CO,Mineral,464,438,26,5.60
CO,Moffat,7162,6749,413,5.80
CO,Montezuma,12626,11760,866,6.90
CO,Montrose,21491,20134,1357,6.30
CO,Morgan,15899,15089,810,5.10
CO,Otero,8179,7701,478,5.80
CO,Ouray,2481,2291,190,7.70
CO,Park,10969,10370,599,5.50
CO,Phillips,2459,2396,63,2.60
CO,Pitkin,11122,10017,1105,9.90
CO,Prowers,6114,5856,258,4.20
CO,Pueblo,76155,70230,5925,7.80
CO,Rio Blanco,2905,2754,151,5.20
CO,Rio Grande,5360,4993,367,6.80
CO,Routt,15923,14729,1194,7.50
CO,Saguache,3405,3176,229,6.70
CO,San Juan,519,486,33,6.40
CO,San Miguel,5425,4865,560,10.30
CO,Sedgwick,1154,1115,39,3.40
CO,Summit,21962,19912,2050,9.30
CO,Teller,12836,11924,912,7.10
CO,Washington,2844,2759,85,3.00
CO,Weld,164840,153943,10897,6.60
CO,Yuma,5552,5404,148,2.70
CT,Fairfield,473208,436155,37053,7.80
CT,Hartford,482601,443952,38649,8.00
CT,Litchfield,103484,96504,6980,6.70
CT,Middlesex,93209,87216,5993,6.40
CT,New Haven,462508,426061,36447,7.90
CT,New London,133743,121093,12650,9.50
CT,Tolland,85905,80682,5223,6.10
CT,Windham,63124,58291,4833,7.70
DE,Kent,79826,73170,6656,8.30
DE,New Castle,298781,276479,22302,7.50
DE,Sussex,107206,99465,7741,7.20
District of Columbia,District of Columbia,386296,355788,30508,7.90
FL,Alachua,134486,126648,7838,5.80
FL,Baker,11655,11020,635,5.40
FL,Bay,82680,77353,5327,6.40
FL,Bradford,10713,10018,695,6.50
FL,Brevard,281504,261302,20202,7.20
FL,Broward,1021021,923137,97884,9.60
FL,Calhoun,4744,4479,265,5.60
FL,Charlotte,71385,65764,5621,7.90
FL,Citrus,46588,42350,4238,9.10
FL,Clay,104580,98510,6070,5.80
FL,Collier,176321,163139,13182,7.50
FL,Columbia,29435,27537,1898,6.40
FL,DeSoto,14350,13549,801,5.60
FL,Dixie,5845,5495,350,6.00
FL,Duval,480408,444860,35548,7.40
FL,Escambia,143637,133112,10525,7.30
FL,Flagler,47089,43263,3826,8.10
FL,Franklin,4651,4380,271,5.80
FL,Gadsden,18212,16840,1372,7.50
FL,Gilchrist,7035,6661,374,5.30
FL,Glades,5070,4755,315,6.20
FL,Gulf,5074,4754,320,6.30
FL,Hamilton,4210,3856,354,8.40
FL,Hardee,8466,7871,595,7.00
FL,Hendry,15287,13907,1380,9.00
FL,Hernando,71952,65730,6222,8.60
FL,Highlands,34624,31723,2901,8.40
FL,Hillsborough,754031,695631,58400,7.70
FL,Holmes,6814,6407,407,6.00
FL,Indian River,64151,59027,5124,8.00
FL,Jackson,17124,16107,1017,5.90
FL,Jefferson,5413,5085,328,6.10
FL,Lafayette,2769,2640,129,4.70
FL,Lake,156772,142000,14772,9.40
FL,Lee,345113,317759,27354,7.90
FL,Leon,150692,141137,9555,6.30
FL,Levy,16479,15398,1081,6.60
FL,Liberty,2592,2457,135,5.20
FL,Madison,7546,7042,504,6.70
FL,Manatee,175685,162804,12881,7.30
FL,Marion,138952,128343,10609,7.60
FL,Martin,71353,66677,4676,6.60
FL,Miami-Dade,1280601,1175315,105286,8.20
FL,Monroe,44444,40725,3719,8.40
FL,Nassau,41553,39035,2518,6.10
FL,Okaloosa,95234,89599,5635,5.90
FL,Okeechobee,17090,16089,1001,5.90
FL,Orange,741842,656788,85054,11.50
FL,Osceola,190165,162828,27337,14.40
FL,Palm Beach,715415,656556,58859,8.20
FL,Pasco,240726,222182,18544,7.70
FL,Pinellas,476669,440134,36535,7.70
FL,Polk,319699,288447,31252,9.80
FL,Putnam,26398,24111,2287,8.70
FL,St. Johns,137667,130012,7655,5.60
FL,St. Lucie,146919,134666,12253,8.30
FL,Santa Rosa,82862,78224,4638,5.60
FL,Sarasota,183985,170423,13562,7.40
FL,Seminole,237580,219095,18485,7.80
FL,Sumter,32660,29876,2784,8.50
FL,Suwannee,17637,16549,1088,6.20
FL,Taylor,8151,7586,565,6.90
FL,Union,4532,4299,233,5.10
FL,Volusia,248723,228265,20458,8.20
FL,Wakulla,14994,14272,722,4.80
FL,Walton,32348,30321,2027,6.30
FL,Washington,9438,8843,595,6.30
GA,Appling,9197,8767,430,4.70
GA,Atkinson,4453,4280,173,3.90
GA,Bacon,4847,4622,225,4.60
GA,Baker,1126,1059,67,6.00
GA,Baldwin,17666,16453,1213,6.90
GA,Banks,9825,9407,418,4.30
GA,Barrow,40846,38791,2055,5.00
GA,Bartow,50018,46932,3086,6.20
GA,Ben Hill,5495,5120,375,6.80
GA,Berrien,7425,7000,425,5.70
GA,Bibb,67232,62222,5010,7.50
GA,Bleckley,4509,4218,291,6.50
GA,Brantley,7018,6645,373,5.30
GA,Brooks,6745,6391,354,5.20
GA,Bryan,19103,18121,982,5.10
GA,Bulloch,37178,34769,2409,6.50
GA,Burke,9036,8391,645,7.10
GA,Butts,10844,10183,661,6.10
GA,Calhoun,2237,2122,115,5.10
GA,Camden,21106,20100,1006,4.80
GA,Candler,5732,5482,250,4.40
GA,Carroll,54696,51259,3437,6.30
GA,Catoosa,32604,31183,1421,4.40
GA,Charlton,4873,4687,186,3.80
GA,Chatham,139696,129111,10585,7.60
GA,Chattahoochee,1919,1798,121,6.30
GA,Chattooga,9754,8943,811,8.30
GA,Cherokee,135061,128633,6428,4.80
GA,Clarke,57996,54293,3703,6.40
GA,Clay,901,791,110,12.20
GA,Clayton,138704,124431,14273,10.30
GA,Clinch,2961,2846,115,3.90
GA,Cobb,412115,387938,24177,5.90
GA,Coffee,18941,17845,1096,5.80
GA,Colquitt,21863,20888,975,4.50
GA,Columbia,75307,72176,3131,4.20
GA,Cook,8099,7715,384,4.70
GA,Coweta,74415,69877,4538,6.10
GA,Crawford,5414,5139,275,5.10
GA,Crisp,9714,8841,873,9.00
GA,Dade,7784,7463,321,4.10
GA,Dawson,12665,12082,583,4.60
GA,Decatur,11320,10778,542,4.80
GA,DeKalb,393461,362325,31136,7.90
GA,Dodge,6922,6508,414,6.00
GA,Dooly,4974,4528,446,9.00
GA,Dougherty,37482,34250,3232,8.60
GA,Douglas,72409,67092,5317,7.30
GA,Early,4418,4164,254,5.70
GA,Echols,1882,1808,74,3.90
GA,Effingham,31877,30316,1561,4.90
GA,Elbert,7931,7386,545,6.90
GA,Emanuel,8568,7971,597,7.00
GA,Evans,5008,4751,257,5.10
GA,Fannin,11132,10608,524,4.70
GA,Fayette,56597,53572,3025,5.30
GA,Floyd,43126,40440,2686,6.20
GA,Forsyth,122975,117458,5517,4.50
GA,Franklin,9892,9315,577,5.80
GA,Fulton,558764,514565,44199,7.90
GA,Gilmer,12019,11460,559,4.70
GA,Glascock,1246,1196,50,4.00
GA,Glynn,38295,35722,2573,6.70
GA,Gordon,28096,26579,1517,5.40
GA,Grady,10622,10160,462,4.30
GA,Greene,7190,6774,416,5.80
GA,Gwinnett,480249,450036,30213,6.30
GA,Habersham,18721,17713,1008,5.40
GA,Hall,102326,97547,4779,4.70
GA,Hancock,2540,2317,223,8.80
GA,Haralson,12369,11651,718,5.80
GA,Harris,16845,16087,758,4.50
GA,Hart,11329,10719,610,5.40
GA,Heard,5107,4778,329,6.40
GA,Henry,116410,107965,8445,7.30
GA,Houston,70486,66812,3674,5.20
GA,Irwin,3484,3289,195,5.60
GA,Jackson,40061,38323,1738,4.30
GA,Jasper,6818,6487,331,4.90
GA,Jeff Davis,6133,5820,313,5.10
GA,Jefferson,6674,6227,447,6.70
GA,Jenkins,3189,2988,201,6.30
GA,Johnson,4001,3805,196,4.90
GA,Jones,13365,12761,604,4.50
GA,Lamar,7984,7483,501,6.30
GA,Lanier,3801,3602,199,5.20
GA,Laurens,19280,18000,1280,6.60
GA,Lee,15026,14343,683,4.50
GA,Liberty,25708,24110,1598,6.20
GA,Lincoln,3508,3320,188,5.40
GA,Long,8184,7828,356,4.30
GA,Lowndes,51492,48386,3106,6.00
GA,Lumpkin,16557,15770,787,4.80
GA,McDuffie,8550,7877,673,7.90
GA,McIntosh,5946,5611,335,5.60
GA,Macon,4653,4300,353,7.60
GA,Madison,13217,12553,664,5.00
GA,Marion,3238,3075,163,5.00
GA,Meriwether,8741,7991,750,8.60
GA,Miller,2770,2660,110,4.00
GA,Mitchell,8287,7746,541,6.50
GA,Monroe,12899,12254,645,5.00
GA,Montgomery,3831,3625,206,5.40
GA,Morgan,9222,8732,490,5.30
GA,Murray,15378,14230,1148,7.50
GA,Muscogee,77213,71219,5994,7.80
GA,Newton,52123,48448,3675,7.10
GA,Oconee,19609,18893,716,3.70
GA,Oglethorpe,6845,6522,323,4.70
GA,Paulding,86807,82242,4565,5.30
GA,Peach,11835,11102,733,6.20
GA,Pickens,15031,14319,712,4.70
GA,Pierce,8513,8129,384,4.50
GA,Pike,8697,8271,426,4.90
GA,Polk,18280,17199,1081,5.90
GA,Pulaski,3953,3767,186,4.70
GA,Putnam,8289,7756,533,6.40
GA,Quitman,795,745,50,6.30
GA,Rabun,7235,6854,381,5.30
GA,Randolph,2466,2320,146,5.90
GA,Richmond,84055,77658,6397,7.60
GA,Rockdale,43615,40322,3293,7.60
GA,Schley,2146,2054,92,4.30
GA,Screven,5047,4638,409,8.10
GA,Seminole,3096,2942,154,5.00
GA,Spalding,28339,26205,2134,7.50
GA,Stephens,10428,9767,661,6.30
GA,Stewart,2513,2373,140,5.60
GA,Sumter,12586,11651,935,7.40
GA,Talbot,2756,2570,186,6.70
GA,Taliaferro,533,495,38,7.10
GA,Tattnall,9670,9258,412,4.30
GA,Taylor,2768,2569,199,7.20
GA,Telfair,3799,3426,373,9.80
GA,Terrell,3527,3264,263,7.50
GA,Thomas,16997,15944,1053,6.20
GA,Tift,20533,19496,1037,5.10
GA,Toombs,12159,11372,787,6.50
GA,Towns,3871,3617,254,6.60
GA,Treutlen,2658,2497,161,6.10
GA,Troup,37586,34897,2689,7.20
GA,Turner,3262,3025,237,7.30
GA,Twiggs,2786,2579,207,7.40
GA,Union,10546,10087,459,4.40
GA,Upson,11367,10625,742,6.50
GA,Walker,30562,29065,1497,4.90
GA,Walton,45552,43123,2429,5.30
GA,Ware,15302,14456,846,5.50
GA,Warren,2639,2461,178,6.70
GA,Washington,6924,6483,441,6.40
GA,Wayne,11557,10916,641,5.50
GA,Webster,1015,958,57,5.60
GA,Wheeler,1611,1495,116,7.20
GA,White,16247,15545,702,4.30
GA,Whitfield,43110,40013,3097,7.20
GA,Wilcox,2754,2588,166,6.00
GA,Wilkes,3642,3397,245,6.70
GA,Wilkinson,3801,3600,201,5.30
GA,Worth,8813,8335,478,5.40
HI,Hawaii,91636,80942,10694,11.70
HI,Honolulu/city,449402,402127,47275,10.50
HI,Kauai,36330,30307,6023,16.60
HI,Maui,85122,69603,15519,18.20
ID,Ada,259488,245265,14223,5.50
ID,Adams,1776,1606,170,9.60
ID,Bannock,42314,40211,2103,5.00
ID,Bear Lake,3088,2956,132,4.30
ID,Benewah,4164,3843,321,7.70
ID,Bingham,23923,22984,939,3.90
ID,Blaine,12800,11790,1010,7.90
ID,Boise,3647,3353,294,8.10
ID,Bonner,21174,19536,1638,7.70
ID,Bonneville,58505,56095,2410,4.10
ID,Boundary,5538,5186,352,6.40
ID,Butte,1394,1343,51,3.70
ID,Camas,691,657,34,4.90
ID,Canyon,107190,100806,6384,6.00
ID,Caribou,4123,3972,151,3.70
ID,Cassia,12447,11982,465,3.70
ID,Clark,378,363,15,4.00
ID,Clearwater,3044,2787,257,8.40
ID,Custer,2239,2125,114,5.10
ID,Elmore,11910,11323,587,4.90
ID,Franklin,7182,6922,260,3.60
ID,Fremont,7922,7625,297,3.70
ID,Gem,8519,8010,509,6.00
ID,Gooding,8300,7977,323,3.90
ID,Idaho,6738,6279,459,6.80
ID,Jefferson,14201,13703,498,3.50
ID,Jerome,12174,11674,500,4.10
ID,Kootenai,81939,76149,5790,7.10
ID,Latah,19745,18787,958,4.90
ID,Lemhi,3654,3405,249,6.80
ID,Lewis,1658,1527,131,7.90
ID,Lincoln,2657,2496,161,6.10
ID,Madison,22398,21780,618,2.80
ID,Minidoka,11686,11226,460,3.90
ID,Nez Perce,20899,19861,1038,5.00
ID,Oneida,2348,2248,100,4.30
ID,Owyhee,5556,5221,335,6.00
ID,Payette,12012,11362,650,5.40
ID,Power,4139,3968,171,4.10
ID,Shoshone,5473,4963,510,9.30
ID,Teton,6701,6316,385,5.70
ID,Twin Falls,41544,39322,2222,5.30
ID,Valley,5691,5231,460,8.10
ID,Washington,4769,4505,264,5.50
IL,Adams,31139,29136,2003,6.40
IL,Alexander,1834,1644,190,10.40
IL,Bond,7396,6876,520,7.00
IL,Boone,25318,22421,2897,11.40
IL,Brown,2981,2864,117,3.90
IL,Bureau,16377,15110,1267,7.70
IL,Calhoun,2171,1999,172,7.90
IL,Carroll,7432,6892,540,7.30
IL,Cass,5810,5417,393,6.80
IL,Champaign,106836,99733,7103,6.60
IL,Christian,13498,12378,1120,8.30
IL,Clark,7285,6699,586,8.00
IL,Clay,6194,5601,593,9.60
IL,Clinton,19653,18485,1168,5.90
IL,Coles,23059,21314,1745,7.60
IL,Cook,2624052,2351173,272879,10.40
IL,Crawford,8385,7789,596,7.10
IL,Cumberland,5926,5582,344,5.80
IL,DeKalb,52854,48449,4405,8.30
IL,De Witt,6993,6523,470,6.70
IL,Douglas,9964,9391,573,5.80
IL,DuPage,503125,465172,37953,7.50
IL,Edgar,8875,8277,598,6.70
IL,Edwards,2651,2426,225,8.50
IL,Effingham,19186,17889,1297,6.80
IL,Fayette,9700,8963,737,7.60
IL,Ford,6156,5746,410,6.70
IL,Franklin,15935,14230,1705,10.70
IL,Fulton,14556,13290,1266,8.70
IL,Gallatin,2009,1819,190,9.50
IL,Greene,5882,5491,391,6.60
IL,Grundy,25379,23211,2168,8.50
IL,Hamilton,4201,3918,283,6.70
IL,Hancock,8064,7496,568,7.00
IL,Hardin,1288,1166,122,9.50
IL,Henderson,3534,3283,251,7.10
IL,Henry,23700,21809,1891,8.00
IL,Iroquois,13541,12684,857,6.30
IL,Jackson,27136,25004,2132,7.90
IL,Jasper,4572,4290,282,6.20
IL,Jefferson,16941,15220,1721,10.20
IL,Jersey,10580,9770,810,7.70
IL,Jo Daviess,10435,9559,876,8.40
IL,Johnson,4083,3712,371,9.10
IL,Kane,261149,236858,24291,9.30
IL,Kankakee,53863,49036,4827,9.00
IL,Kendall,70224,64661,5563,7.90
IL,Knox,21053,19199,1854,8.80
IL,Lake,363910,334143,29767,8.20
IL,LaSalle,52669,47627,5042,9.60
IL,Lawrence,5747,5226,521,9.10
IL,Lee,17085,15894,1191,7.00
IL,Livingston,15874,14784,1090,6.90
IL,Logan,12057,11226,831,6.90
IL,McDonough,12774,11844,930,7.30
IL,McHenry,164754,151528,13226,8.00
IL,McLean,84781,78925,5856,6.90
IL,Macon,47056,42338,4718,10.00
IL,Macoupin,21896,20351,1545,7.10
IL,Madison,130887,120552,10335,7.90
IL,Marion,17044,15441,1603,9.40
IL,Marshall,5060,4680,380,7.50
IL,Mason,5908,5428,480,8.10
IL,Massac,5413,4866,547,10.10
IL,Menard,6043,5647,396,6.60
IL,Mercer,7597,6971,626,8.20
IL,Monroe,18371,17334,1037,5.60
IL,Montgomery,11430,10421,1009,8.80
IL,Morgan,15854,14746,1108,7.00
IL,Moultrie,7244,6870,374,5.20
IL,Ogle,24093,22102,1991,8.30
IL,Peoria,83410,74688,8722,10.50
IL,Perry,8068,7298,770,9.50
IL,Piatt,8351,7887,464,5.60
IL,Pike,6731,6323,408,6.10
IL,Pope,1638,1506,132,8.10
IL,Pulaski,1757,1549,208,11.80
IL,Putnam,2938,2689,249,8.50
IL,Randolph,13728,12740,988,7.20
IL,Richland,7350,6843,507,6.90
IL,Rock Island,68489,61912,6577,9.60
IL,St. Clair,124057,112587,11470,9.20
IL,Saline,9502,8559,943,9.90
IL,Sangamon,96553,88467,8086,8.40
IL,Schuyler,3126,2929,197,6.30
IL,Scott,2347,2189,158,6.70
IL,Shelby,10210,9539,671,6.60
IL,Stark,2352,2178,174,7.40
IL,Stephenson,21056,19492,1564,7.40
IL,Tazewell,61851,56747,5104,8.30
IL,Union,7175,6585,590,8.20
IL,Vermilion,32302,29399,2903,9.00
IL,Wabash,5673,5193,480,8.50
IL,Warren,8049,7541,508,6.30
IL,Washington,9528,9019,509,5.30
IL,Wayne,6760,6190,570,8.40
IL,White,6084,5605,479,7.90
IL,Whiteside,27618,25367,2251,8.20
IL,Will,358767,326219,32548,9.10
IL,Williamson,31360,28585,2775,8.80
IL,Winnebago,135434,119837,15597,11.50
IL,Woodford,17945,16831,1114,6.20
IN,Adams,16776,15831,945,5.60
IN,Allen,185442,170981,14461,7.80
IN,Bartholomew,43673,40792,2881,6.60
IN,Benton,4162,3938,224,5.40
IN,Blackford,4829,4440,389,8.10
IN,Boone,36106,34547,1559,4.30
IN,Brown,7532,7018,514,6.80
IN,Carroll,9408,8816,592,6.30
IN,Cass,17636,16420,1216,6.90
IN,Clark,61662,57175,4487,7.30
IN,Clay,11593,10826,767,6.60
IN,Clinton,16738,15785,953,5.70
IN,Crawford,4869,4515,354,7.30
IN,Daviess,16549,15909,640,3.90
IN,Dearborn,25346,23576,1770,7.00
IN,Decatur,14956,13821,1135,7.60
IN,DeKalb,22211,20670,1541,6.90
IN,Delaware,52470,48593,3877,7.40
IN,Dubois,22595,21563,1032,4.60
IN,Elkhart,110525,102105,8420,7.60
IN,Fayette,8600,7753,847,9.80
IN,Floyd,41324,38615,2709,6.60
IN,Fountain,7732,7219,513,6.60
IN,Franklin,11319,10644,675,6.00
IN,Fulton,9676,9034,642,6.60
IN,Gibson,19577,18352,1225,6.30
IN,Grant,31602,29582,2020,6.40
IN,Greene,13267,12435,832,6.30
IN,Hamilton,184949,176246,8703,4.70
IN,Hancock,40767,38451,2316,5.70
IN,Harrison,19966,18699,1267,6.30
IN,Hendricks,90251,85655,4596,5.10
IN,Henry,21883,20431,1452,6.60
IN,Howard,37140,33065,4075,11.00
IN,Huntington,18060,16857,1203,6.70
IN,Jackson,23103,21431,1672,7.20
IN,Jasper,15535,14428,1107,7.10
IN,Jay,8815,8231,584,6.60
IN,Jefferson,14955,13834,1121,7.50
IN,Jennings,13559,12508,1051,7.80
IN,Johnson,82993,78282,4711,5.70
IN,Knox,18271,17175,1096,6.00
IN,Kosciusko,41373,38796,2577,6.20
IN,LaGrange,19299,18047,1252,6.50
IN,Lake,226215,202695,23520,10.40
IN,LaPorte,47361,42770,4591,9.70
IN,Lawrence,20682,19223,1459,7.10
IN,Madison,58444,53754,4690,8.00
IN,Marion,492797,453225,39572,8.00
IN,Marshall,22685,21212,1473,6.50
IN,Martin,5407,5173,234,4.30
IN,Miami,15180,13928,1252,8.20
IN,Monroe,67917,64099,3818,5.60
IN,Montgomery,18609,17632,977,5.30
IN,Morgan,35482,33531,1951,5.50
IN,Newton,6557,6100,457,7.00
IN,Noble,22856,20926,1930,8.40
IN,Ohio,3158,2923,235,7.40
IN,Orange,8504,7552,952,11.20
IN,Owen,9015,8436,579,6.40
IN,Parke,6853,6474,379,5.50
IN,Perry,9079,8480,599,6.60
IN,Pike,6171,5808,363,5.90
IN,Porter,84310,77433,6877,8.20
IN,Posey,12774,12136,638,5.00
IN,Pulaski,6401,6009,392,6.10
IN,Putnam,16188,15155,1033,6.40
IN,Randolph,11194,10452,742,6.60
IN,Ripley,13919,13020,899,6.50
IN,Rush,8766,8213,553,6.30
IN,St. Joseph,133500,122108,11392,8.50
IN,Scott,10463,9569,894,8.50
IN,Shelby,23019,21342,1677,7.30
IN,Spencer,10337,9754,583,5.60
IN,Starke,9746,8954,792,8.10
IN,Steuben,19907,18649,1258,6.30
IN,Sullivan,7965,7407,558,7.00
IN,Switzerland,4805,4413,392,8.20
IN,Tippecanoe,91769,85742,6027,6.60
IN,Tipton,9028,8465,563,6.20
IN,Union,3468,3274,194,5.60
IN,Vanderburgh,92161,85529,6632,7.20
IN,Vermillion,6598,6098,500,7.60
IN,Vigo,46209,42549,3660,7.90
IN,Wabash,14471,13578,893,6.20
IN,Warren,3964,3745,219,5.50
IN,Warrick,31818,30074,1744,5.50
IN,Washington,13558,12609,949,7.00
IN,Wayne,30125,28071,2054,6.80
IN,Wells,13871,13059,812,5.90
IN,White,13168,12492,676,5.10
IN,Whitley,17272,16233,1039,6.00
IA,Adair,4239,4076,163,3.80
IA,Adams,2057,1981,76,3.70
IA,Allamakee,7098,6746,352,5.00
IA,Appanoose,5934,5625,309,5.20
IA,Audubon,3026,2924,102,3.40
IA,Benton,12916,12274,642,5.00
IA,Black Hawk,67814,63732,4082,6.00
IA,Boone,14580,14002,578,4.00
IA,Bremer,13783,13259,524,3.80
IA,Buchanan,11208,10708,500,4.50
IA,Buena Vista,11740,11319,421,3.60
IA,Butler,7740,7389,351,4.50
IA,Calhoun,4102,3938,164,4.00
IA,Carroll,10611,10201,410,3.90
IA,Cass,6802,6543,259,3.80
IA,Cedar,10468,10022,446,4.30
IA,Cerro Gordo,23259,22076,1183,5.10
IA,Cherokee,6235,6004,231,3.70
IA,Chickasaw,6326,6038,288,4.60
IA,Clarke,4804,4552,252,5.20
IA,Clay,8438,8068,370,4.40
IA,Clayton,9739,9197,542,5.60
IA,Clinton,22182,20724,1458,6.60
IA,Crawford,7992,7580,412,5.20
IA,Dallas,51107,49331,1776,3.50
IA,Davis,4150,3987,163,3.90
IA,Decatur,4231,4073,158,3.70
IA,Delaware,10470,10065,405,3.90
IA,Des Moines,18726,17364,1362,7.30
IA,Dickinson,9853,9364,489,5.00
IA,Dubuque,55483,52324,3159,5.70
IA,Emmet,5075,4830,245,4.80
IA,Fayette,10323,9771,552,5.30
IA,Floyd,8299,7810,489,5.90
IA,Franklin,5630,5421,209,3.70
IA,Fremont,3724,3612,112,3.00
IA,Greene,5350,5128,222,4.10
IA,Grundy,6338,6068,270,4.30
IA,Guthrie,5432,5167,265,4.90
IA,Hamilton,6828,6534,294,4.30
IA,Hancock,5796,5533,263,4.50
IA,Hardin,7835,7481,354,4.50
IA,Harrison,7026,6745,281,4.00
IA,Henry,9530,9036,494,5.20
IA,Howard,5137,4914,223,4.30
IA,Humboldt,4974,4769,205,4.10
IA,Ida,4008,3868,140,3.50
IA,Iowa,10137,9701,436,4.30
IA,Jackson,10670,10035,635,6.00
IA,Jasper,19327,18323,1004,5.20
IA,Jefferson,9868,9337,531,5.40
IA,Johnson,85204,81202,4002,4.70
IA,Jones,10303,9730,573,5.60
IA,Keokuk,5183,4933,250,4.80
IA,Kossuth,8167,7865,302,3.70
IA,Lee,15759,14748,1011,6.40
IA,Linn,120317,112852,7465,6.20
IA,Louisa,5985,5697,288,4.80
IA,Lucas,4645,4479,166,3.60
IA,Lyon,6889,6720,169,2.50
IA,Madison,8419,7949,470,5.60
IA,Mahaska,11930,11375,555,4.70
IA,Marion,18077,17337,740,4.10
IA,Marshall,17659,16435,1224,6.90
IA,Mills,7013,6738,275,3.90
IA,Mitchell,6098,5896,202,3.30
IA,Monona,4401,4197,204,4.60
IA,Monroe,3975,3774,201,5.10
IA,Montgomery,4890,4667,223,4.60
IA,Muscatine,21452,20215,1237,5.80
IA,O'Brien,8152,7884,268,3.30
IA,Osceola,3528,3428,100,2.80
IA,Page,6239,5935,304,4.90
IA,Palo Alto,4582,4377,205,4.50
IA,Plymouth,14431,13923,508,3.50
IA,Pocahontas,4242,4097,145,3.40
IA,Polk,266206,250540,15666,5.90
IA,Pottawattamie,47408,44961,2447,5.20
IA,Poweshiek,9832,9360,472,4.80
IA,Ringgold,2388,2298,90,3.80
IA,Sac,5206,5026,180,3.50
IA,Scott,87409,81621,5788,6.60
IA,Shelby,6390,6165,225,3.50
IA,Sioux,21310,20761,549,2.60
IA,Story,57091,55080,2011,3.50
IA,Tama,9295,8828,467,5.00
IA,Taylor,3094,2984,110,3.60
IA,Union,6204,5850,354,5.70
IA,Van Buren,3694,3529,165,4.50
IA,Wapello,17461,16440,1021,5.80
IA,Warren,27926,26685,1241,4.40
IA,Washington,11484,11023,461,4.00
IA,Wayne,2808,2686,122,4.30
IA,Webster,18779,17815,964,5.10
IA,Winnebago,5077,4761,316,6.20
IA,Winneshiek,11200,10666,534,4.80
IA,Woodbury,54904,52079,2825,5.10
IA,Worth,4115,3899,216,5.20
IA,Wright,7019,6747,272,3.90
KS,Allen,6394,6061,333,5.20
KS,Anderson,4283,4114,169,3.90
KS,Atchison,6851,6400,451,6.60
KS,Barber,2312,2240,72,3.10
KS,Barton,13638,13032,606,4.40
KS,Bourbon,6690,6319,371,5.50
KS,Brown,5138,4917,221,4.30
KS,Butler,32383,30314,2069,6.40
KS,Chase,1452,1375,77,5.30
KS,Chautauqua,1479,1391,88,5.90
KS,Cherokee,9974,9469,505,5.10
KS,Cheyenne,1302,1274,28,2.20
KS,Clark,1135,1113,22,1.90
KS,Clay,3808,3644,164,4.30
KS,Cloud,3841,3690,151,3.90
KS,Coffey,3934,3737,197,5.00
KS,Comanche,865,837,28,3.20
KS,Cowley,16774,15711,1063,6.30
KS,Crawford,18931,17920,1011,5.30
KS,Decatur,1224,1182,42,3.40
KS,Dickinson,8867,8455,412,4.60
KS,Doniphan,4136,3951,185,4.50
KS,Douglas,63957,60252,3705,5.80
KS,Edwards,1460,1418,42,2.90
KS,Elk,1167,1112,55,4.70
KS,Ellis,17036,16477,559,3.30
KS,Ellsworth,2704,2623,81,3.00
KS,Finney,20555,19894,661,3.20
KS,Ford,17256,16706,550,3.20
KS,Franklin,14217,13477,740,5.20
KS,Geary,11632,10841,791,6.80
KS,Gove,1460,1423,37,2.50
KS,Graham,1134,1085,49,4.30
KS,Grant,3097,2976,121,3.90
KS,Gray,3235,3167,68,2.10
KS,Greeley,818,805,13,1.60
KS,Greenwood,3103,2945,158,5.10
KS,Hamilton,1615,1590,25,1.50
KS,Harper,2782,2664,118,4.20
KS,Harvey,16768,15902,866,5.20
KS,Haskell,2240,2191,49,2.20
KS,Hodgeman,1015,990,25,2.50
KS,Jackson,7234,6857,377,5.20
KS,Jefferson,10234,9755,479,4.70
KS,Jewell,1249,1213,36,2.90
KS,Johnson,341523,324768,16755,4.90
KS,Kearny,2025,1975,50,2.50
KS,Kingman,3249,3082,167,5.10
KS,Kiowa,1245,1207,38,3.10
KS,Labette,9648,9122,526,5.50
KS,Lane,755,734,21,2.80
KS,Leavenworth,36629,34565,2064,5.60
KS,Lincoln,1734,1686,48,2.80
KS,Linn,4329,4028,301,7.00
KS,Logan,1608,1571,37,2.30
KS,Lyon,16610,15861,749,4.50
KS,McPherson,17161,16596,565,3.30
KS,Marion,5950,5717,233,3.90
KS,Marshall,5482,5321,161,2.90
KS,Meade,2148,2091,57,2.70
KS,Miami,17570,16720,850,4.80
KS,Mitchell,3426,3339,87,2.50
KS,Montgomery,14859,13800,1059,7.10
KS,Morris,3077,2960,117,3.80
KS,Morton,1129,1096,33,2.90
KS,Nemaha,5580,5428,152,2.70
KS,Neosho,6217,5833,384,6.20
KS,Ness,1348,1304,44,3.30
KS,Norton,2644,2578,66,2.50
KS,Osage,7950,7556,394,5.00
KS,Osborne,1972,1920,52,2.60
KS,Ottawa,2971,2852,119,4.00
KS,Pawnee,2850,2751,99,3.50
KS,Phillips,2641,2556,85,3.20
KS,Pottawatomie,12132,11642,490,4.00
KS,Pratt,4921,4751,170,3.50
KS,Rawlins,1544,1506,38,2.50
KS,Reno,29731,28164,1567,5.30
KS,Republic,2313,2241,72,3.10
KS,Rice,5082,4878,204,4.00
KS,Riley,33547,31962,1585,4.70
KS,Rooks,2501,2406,95,3.80
KS,Rush,1572,1502,70,4.50
KS,Russell,3307,3175,132,4.00
KS,Saline,29482,27928,1554,5.30
KS,Scott,2824,2758,66,2.30
KS,Sedgwick,257484,235491,21993,8.50
KS,Seward,9795,9396,399,4.10
KS,Shawnee,91083,85929,5154,5.70
KS,Sheridan,1465,1432,33,2.30
KS,Sherman,2870,2778,92,3.20
KS,Smith,1990,1940,50,2.50
KS,Stafford,2022,1951,71,3.50
KS,Stanton,1075,1052,23,2.10
KS,Stevens,2802,2729,73,2.60
KS,Sumner,10841,9975,866,8.00
KS,Thomas,4233,4121,112,2.60
KS,Trego,1447,1399,48,3.30
KS,Wabaunsee,3676,3529,147,4.00
KS,Wallace,836,820,16,1.90
KS,Washington,3064,2993,71,2.30
KS,Wichita,1243,1220,23,1.90
KS,Wilson,3903,3607,296,7.60
KS,Woodson,1561,1470,91,5.80
KS,Wyandotte,77663,71699,5964,7.70
KY,Adair,7019,6530,489,7.00
KY,Allen,8664,8200,464,5.40
KY,Anderson,11765,11073,692,5.90
KY,Ballard,3324,3113,211,6.30
KY,Barren,18073,16752,1321,7.30
KY,Bath,4537,4172,365,8.00
KY,Bell,8184,7567,617,7.50
KY,Boone,70556,66874,3682,5.20
KY,Bourbon,9568,9025,543,5.70
KY,Boyd,17463,16052,1411,8.10
KY,Boyle,12562,11673,889,7.10
KY,Bracken,3713,3490,223,6.00
KY,Breathitt,3251,2928,323,9.90
KY,Breckinridge,7818,7268,550,7.00
KY,Bullitt,42153,39551,2602,6.20
KY,Butler,4858,4528,330,6.80
KY,Caldwell,5585,5253,332,5.90
KY,Calloway,17775,16707,1068,6.00
KY,Campbell,49546,46891,2655,5.40
KY,Carlisle,2162,2065,97,4.50
KY,Carroll,5293,4991,302,5.70
KY,Carter,9522,8635,887,9.30
KY,Casey,6655,6255,400,6.00
KY,Christian,24460,22573,1887,7.70
KY,Clark,16960,15887,1073,6.30
KY,Clay,5168,4742,426,8.20
KY,Clinton,3952,3757,195,4.90
KY,Crittenden,3673,3476,197,5.40
KY,Cumberland,3255,3101,154,4.70
KY,Daviess,45857,43163,2694,5.90
KY,Edmonson,4589,4247,342,7.50
KY,Elliott,1950,1761,189,9.70
KY,Estill,5137,4761,376,7.30
KY,Fayette,171813,162258,9555,5.60
KY,Fleming,6108,5675,433,7.10
KY,Floyd,10643,9707,936,8.80
KY,Franklin,24731,23168,1563,6.30
KY,Fulton,1985,1857,128,6.40
KY,Gallatin,3948,3718,230,5.80
KY,Garrard,7516,7058,458,6.10
KY,Grant,11589,10796,793,6.80
KY,Graves,15560,14669,891,5.70
KY,Grayson,10641,9840,801,7.50
KY,Green,5146,4878,268,5.20
KY,Greenup,13145,12010,1135,8.60
KY,Hancock,3812,3587,225,5.90
KY,Hardin,47658,44370,3288,6.90
KY,Harlan,6506,5764,742,11.40
KY,Harrison,8672,8156,516,6.00
KY,Hart,7638,7157,481,6.30
KY,Henderson,20663,19427,1236,6.00
KY,Henry,8023,7574,449,5.60
KY,Hickman,1718,1630,88,5.10
KY,Hopkins,18021,16728,1293,7.20
KY,Jackson,4038,3701,337,8.30
KY,Jefferson,389470,363625,25845,6.60
KY,Jessamine,25934,24522,1412,5.40
KY,Johnson,6584,6036,548,8.30
KY,Kenton,85978,81166,4812,5.60
KY,Knott,4287,3934,353,8.20
KY,Knox,9874,9089,785,8.00
KY,Larue,5841,5432,409,7.00
KY,Laurel,24918,23247,1671,6.70
KY,Lawrence,5206,4788,418,8.00
KY,Lee,2042,1905,137,6.70
KY,Leslie,2578,2307,271,10.50
KY,Letcher,6062,5468,594,9.80
KY,Lewis,4653,4225,428,9.20
KY,Lincoln,9211,8502,709,7.70
KY,Livingston,3499,3242,257,7.30
KY,Logan,12103,11454,649,5.40
KY,Lyon,3054,2897,157,5.10
KY,McCracken,28743,26768,1975,6.90
KY,McCreary,4822,4485,337,7.00
KY,McLean,3965,3746,219,5.50
KY,Madison,45840,43156,2684,5.90
KY,Magoffin,3179,2685,494,15.50
KY,Marion,9215,8515,700,7.60
KY,Marshall,14798,13915,883,6.00
KY,Martin,2474,2196,278,11.20
KY,Mason,6853,6324,529,7.70
KY,Meade,11749,10939,810,6.90
KY,Menifee,2250,2056,194,8.60
KY,Mercer,9863,9168,695,7.00
KY,Metcalfe,3982,3680,302,7.60
KY,Monroe,4558,4321,237,5.20
KY,Montgomery,11324,10450,874,7.70
KY,Morgan,4395,4106,289,6.60
KY,Muhlenberg,9913,9080,833,8.40
KY,Nelson,22696,21163,1533,6.80
KY,Nicholas,3271,3051,220,6.70
KY,Ohio,9273,8626,647,7.00
KY,Oldham,32443,30919,1524,4.70
KY,Owen,5085,4770,315,6.20
KY,Owsley,1078,978,100,9.30
KY,Pendleton,6759,6417,342,5.10
KY,Perry,8132,7432,700,8.60
KY,Pike,19098,17552,1546,8.10
KY,Powell,5045,4684,361,7.20
KY,Pulaski,25723,23893,1830,7.10
KY,Robertson,787,741,46,5.80
KY,Rockcastle,6371,5918,453,7.10
KY,Rowan,9966,9246,720,7.20
KY,Russell,6068,5582,486,8.00
KY,Scott,29874,28069,1805,6.00
KY,Shelby,25410,24072,1338,5.30
KY,Simpson,8516,7917,599,7.00
KY,Spencer,10342,9766,576,5.60
KY,Taylor,12971,12220,751,5.80
KY,Todd,5392,5141,251,4.70
KY,Trigg,5965,5562,403,6.80
KY,Trimble,3782,3533,249,6.60
KY,Union,5924,5558,366,6.20
KY,Warren,63444,59408,4036,6.40
KY,Washington,6081,5710,371,6.10
KY,Wayne,7344,6883,461,6.30
KY,Webster,5410,5073,337,6.20
KY,Whitley,13791,12841,950,6.90
KY,Wolfe,2079,1925,154,7.40
KY,Woodford,14851,14132,719,4.80
LA,Acadia Parish,23311,21493,1818,7.80
LA,Allen Parish,8392,7574,818,9.70
LA,Ascension Parish,64283,59710,4573,7.10
LA,Assumption Parish,8772,7834,938,10.70
LA,Avoyelles Parish,14925,13656,1269,8.50
LA,Beauregard Parish,14387,13355,1032,7.20
LA,Bienville Parish,5374,4933,441,8.20
LA,Bossier Parish,56751,52939,3812,6.70
LA,Caddo Parish,101444,91806,9638,9.50
LA,Calcasieu Parish,97332,88018,9314,9.60
LA,Caldwell Parish,3649,3361,288,7.90
LA,Cameron Parish,3504,3288,216,6.20
LA,Catahoula Parish,3447,3185,262,7.60
LA,Claiborne Parish,5458,5069,389,7.10
LA,Concordia Parish,6894,6289,605,8.80
LA,De Soto Parish,10688,9864,824,7.70
LA,East Baton Rouge Parish,225973,207325,18648,8.30
LA,East Carroll Parish,1813,1583,230,12.70
LA,East Feliciana Parish,7566,7024,542,7.20
LA,Evangeline Parish,11940,10953,987,8.30
LA,Franklin Parish,7317,6678,639,8.70
LA,Grant Parish,8118,7547,571,7.00
LA,Iberia Parish,27493,24724,2769,10.10
LA,Iberville Parish,13642,12212,1430,10.50
LA,Jackson Parish,6720,6333,387,5.80
LA,Jefferson Parish,209463,189241,20222,9.70
LA,Jefferson Davis Parish,12728,11702,1026,8.10
LA,Lafayette Parish,114141,105578,8563,7.50
LA,Lafourche Parish,41152,38299,2853,6.90
LA,LaSalle Parish,6827,6475,352,5.20
LA,Lincoln Parish,20987,19584,1403,6.70
LA,Livingston Parish,68727,64067,4660,6.80
LA,Madison Parish,3532,3211,321,9.10
LA,Morehouse Parish,10017,8971,1046,10.40
LA,Natchitoches Parish,16083,14903,1180,7.30
LA,Orleans Parish,179774,157276,22498,12.50
LA,Ouachita Parish,69374,63914,5460,7.90
LA,Plaquemines Parish,9528,8817,711,7.50
LA,Pointe Coupee Parish,9446,8653,793,8.40
LA,Rapides Parish,54677,51015,3662,6.70
LA,Red River Parish,3584,3345,239,6.70
LA,Richland Parish,8098,7436,662,8.20
LA,Sabine Parish,9201,8652,549,6.00
LA,St. Bernard Parish,19995,17889,2106,10.50
LA,St. Charles Parish,24358,22356,2002,8.20
LA,St. Helena Parish,4239,3720,519,12.20
LA,St. James Parish,8842,7924,918,10.40
LA,St. John the Baptist Parish,19184,16930,2254,11.70
LA,St. Landry Parish,32177,29202,2975,9.20
LA,St. Martin Parish,21773,19886,1887,8.70
LA,St. Mary Parish,19379,17494,1885,9.70
LA,St. Tammany Parish,116652,108347,8305,7.10
LA,Tangipahoa Parish,56126,50450,5676,10.10
LA,Tensas Parish,1342,1221,121,9.00
LA,Terrebonne Parish,45659,41907,3752,8.20
LA,Union Parish,8988,8300,688,7.70
LA,Vermilion Parish,23581,21719,1862,7.90
LA,Vernon Parish,15791,14576,1215,7.70
LA,Washington Parish,16612,15165,1447,8.70
LA,Webster Parish,13948,12771,1177,8.40
LA,West Baton Rouge Parish,13489,12461,1028,7.60
LA,West Carroll Parish,3656,3262,394,10.80
LA,West Feliciana Parish,5169,4869,300,5.80
LA,Winn Parish,4685,4327,358,7.60
ME,Androscoggin,54287,51543,2744,5.10
ME,Aroostook,29199,27715,1484,5.10
ME,Cumberland,160751,152878,7873,4.90
ME,Franklin,13726,12953,773,5.60
ME,Hancock,27710,26239,1471,5.30
ME,Kennebec,61354,58547,2807,4.60
ME,Knox,19562,18584,978,5.00
ME,Lincoln,16386,15584,802,4.90
ME,Oxford,25776,24197,1579,6.10
ME,Penobscot,74210,70505,3705,5.00
ME,Piscataquis,7157,6798,359,5.00
ME,Sagadahoc,19246,18403,843,4.40
ME,Somerset,22010,20662,1348,6.10
ME,Waldo,19981,19035,946,4.70
ME,Washington,13340,12574,766,5.70
ME,York,110537,105050,5487,5.00
MD,Allegany,31382,28925,2457,7.80
MD,Anne Arundel,317403,299113,18290,5.80
MD,Baltimore,452245,421646,30599,6.80
MD,Calvert,49699,47128,2571,5.20
MD,Caroline,17701,16714,987,5.60
MD,Carroll,95028,90205,4823,5.10
MD,Cecil,53323,50171,3152,5.90
MD,Charles,88174,82357,5817,6.60
MD,Dorchester,16553,15467,1086,6.60
MD,Frederick,137540,129513,8027,5.80
MD,Garrett,15623,14574,1049,6.70
MD,Harford,141380,133250,8130,5.80
MD,Howard,188920,179273,9647,5.10
MD,Kent,9836,9186,650,6.60
MD,Montgomery,556465,521828,34637,6.20
MD,Prince George's,512497,471489,41008,8.00
MD,Queen Anne's,28107,26578,1529,5.40
MD,St. Mary's,58492,55673,2819,4.80
MD,Somerset,8726,7989,737,8.40
MD,Talbot,17987,16896,1091,6.10
MD,Washington,73020,68031,4989,6.80
MD,Wicomico,49852,46087,3765,7.60
MD,Worcester,25367,22436,2931,11.60
MD,Baltimore city,282207,257578,24629,8.70
MA,Barnstable,110468,98545,11923,10.80
MA,Berkshire,62370,56266,6104,9.80
MA,Bristol,299978,267445,32533,10.80
MA,Dukes,9542,8598,944,9.90
MA,Essex,424185,380186,43999,10.40
MA,Franklin,40222,37042,3180,7.90
MA,Hampden,225995,201171,24824,11.00
MA,Hampshire,88360,81642,6718,7.60
MA,Middlesex,900978,831412,69566,7.70
MA,Nantucket/town,7622,6775,847,11.10
MA,Norfolk,390023,355614,34409,8.80
MA,Plymouth,283634,255314,28320,10.00
MA,Suffolk,456198,409219,46979,10.30
MA,Worcester,442111,401024,41087,9.30
MI,Alcona,3841,3440,401,10.40
MI,Alger,3120,2768,352,11.30
MI,Allegan,61980,57267,4713,7.60
MI,Alpena,13211,12143,1068,8.10
MI,Antrim,10112,9081,1031,10.20
MI,Arenac,5943,5243,700,11.80
MI,Baraga,3147,2759,388,12.30
MI,Barry,31394,28982,2412,7.70
MI,Bay,49355,44622,4733,9.60
MI,Benzie,8660,7812,848,9.80
MI,Berrien,72419,65825,6594,9.10
MI,Branch,19662,18014,1648,8.40
MI,Calhoun,61755,55530,6225,10.10
MI,Cass,24347,22107,2240,9.20
MI,Charlevoix,12505,11224,1281,10.20
MI,Cheboygan,10315,8770,1545,15.00
MI,Chippewa,15905,14400,1505,9.50
MI,Clare,11700,10288,1412,12.10
MI,Clinton,40183,37457,2726,6.80
MI,Crawford,5589,4975,614,11.00
MI,Delta,16819,15280,1539,9.20
MI,Dickinson,12116,11218,898,7.40
MI,Eaton,56087,51632,4455,7.90
MI,Emmet,17159,15304,1855,10.80
MI,Genesee,179481,158667,20814,11.60
MI,Gladwin,9827,8827,1000,10.20
MI,Gogebic,5812,5341,471,8.10
MI,Grand Traverse,48991,44732,4259,8.70
MI,Gratiot,17788,16310,1478,8.30
MI,Hillsdale,20084,18199,1885,9.40
MI,Houghton,15880,14664,1216,7.70
MI,Huron,15414,14048,1366,8.90
MI,Ingham,146305,134870,11435,7.80
MI,Ionia,30119,27633,2486,8.30
MI,Iosco,10107,8999,1108,11.00
MI,Iron,4928,4505,423,8.60
MI,Isabella,32957,30089,2868,8.70
MI,Jackson,74332,67413,6919,9.30
MI,Kalamazoo,131685,121713,9972,7.60
MI,Kalkaska,7865,6955,910,11.60
MI,Kent,355726,327484,28242,7.90
MI,Keweenaw,895,812,83,9.30
MI,Lake,3954,3509,445,11.30
MI,Lapeer,40521,35571,4950,12.20
MI,Leelanau,10207,9362,845,8.30
MI,Lenawee,45546,41328,4218,9.30
MI,Livingston,100793,92104,8689,8.60
MI,Luce,2224,2022,202,9.10
MI,Mackinac,4932,4248,684,13.90
MI,Macomb,442237,390268,51969,11.80
MI,Manistee,10162,9012,1150,11.30
MI,Marquette,31639,28905,2734,8.60
MI,Mason,13270,11986,1284,9.70
MI,Mecosta,18300,16555,1745,9.50
MI,Menominee,10633,9917,716,6.70
MI,Midland,39208,36115,3093,7.90
MI,Missaukee,6898,6241,657,9.50
MI,Monroe,74146,67313,6833,9.20
MI,Montcalm,27803,25157,2646,9.50
MI,Montmorency,3010,2596,414,13.80
MI,Muskegon,77415,68203,9212,11.90
MI,Newaygo,23274,21172,2102,9.00
MI,Oakland,653339,593872,59467,9.10
MI,Oceana,11998,10695,1303,10.90
MI,Ogemaw,8048,7129,919,11.40
MI,Ontonagon,2043,1822,221,10.80
MI,Osceola,11509,10513,996,8.70
MI,Oscoda,2796,2434,362,12.90
MI,Otsego,11602,10364,1238,10.70
MI,Ottawa,159280,147975,11305,7.10
MI,Presque Isle,4939,4364,575,11.60
MI,Roscommon,7740,6752,988,12.80
MI,Saginaw,84423,75670,8753,10.40
MI,St. Clair,74653,65913,8740,11.70
MI,St. Joseph,28988,26261,2727,9.40
MI,Sanilac,19398,17443,1955,10.10
MI,Schoolcraft,3238,2909,329,10.20
MI,Shiawassee,32699,29589,3110,9.50
MI,Tuscola,23597,21121,2476,10.50
MI,Van Buren,34675,31642,3033,8.70
MI,Washtenaw,193121,180109,13012,6.70
MI,Wayne,801382,693025,108357,13.50
MI,Wexford,14866,13293,1573,10.60
MN,Aitkin,7521,6889,632,8.40
MN,Anoka,201039,187963,13076,6.50
MN,Becker,19037,17812,1225,6.40
MN,Beltrami,25012,23386,1626,6.50
MN,Benton,22187,20675,1512,6.80
MN,Big Stone,2556,2430,126,4.90
MN,Blue Earth,40820,38576,2244,5.50
MN,Brown,14303,13543,760,5.30
MN,Carlton,17824,16497,1327,7.40
MN,Carver,59781,56622,3159,5.30
MN,Cass,14551,13194,1357,9.30
MN,Chippewa,6802,6443,359,5.30
MN,Chisago,30383,28317,2066,6.80
MN,Clay,36616,34987,1629,4.40
MN,Clearwater,4562,4101,461,10.10
MN,Cook,3009,2753,256,8.50
MN,Cottonwood,6371,6062,309,4.90
MN,Crow Wing,32536,30117,2419,7.40
MN,Dakota,245146,229690,15456,6.30
MN,Dodge,12122,11451,671,5.50
MN,Douglas,21402,20352,1050,4.90
MN,Faribault,7157,6704,453,6.30
MN,Fillmore,11754,11137,617,5.20
MN,Freeborn,16311,15365,946,5.80
MN,Goodhue,26889,25281,1608,6.00
MN,Grant,3365,3180,185,5.50
MN,Hennepin,715240,667542,47698,6.70
MN,Houston,10416,9952,464,4.50
MN,Hubbard,10068,9335,733,7.30
MN,Isanti,21987,20462,1525,6.90
MN,Itasca,22295,20337,1958,8.80
MN,Jackson,5832,5519,313,5.40
MN,Kanabec,9178,8412,766,8.30
MN,Kandiyohi,24779,23547,1232,5.00
MN,Kittson,2405,2290,115,4.80
MN,Koochiching,5851,5405,446,7.60
MN,Lac qui Parle,3536,3361,175,4.90
MN,Lake,5363,4967,396,7.40
MN,Lake of the Woods,2449,2295,154,6.30
MN,Le Sueur,16215,15077,1138,7.00
MN,Lincoln,3151,3005,146,4.60
MN,Lyon,14667,13999,668,4.60
MN,McLeod,19429,18289,1140,5.90
MN,Mahnomen,2220,1925,295,13.30
MN,Marshall,5489,5115,374,6.80
MN,Martin,10099,9546,553,5.50
MN,Meeker,13372,12642,730,5.50
MN,Mille Lacs,12969,11833,1136,8.80
MN,Morrison,18043,16780,1263,7.00
MN,Mower,20956,19879,1077,5.10
MN,Murray,4881,4624,257,5.30
MN,Nicollet,20944,19912,1032,4.90
MN,Nobles,11665,11159,506,4.30
MN,Norman,3330,3113,217,6.50
MN,Olmsted,91855,86794,5061,5.50
MN,Otter Tail,31735,29957,1778,5.60
MN,Pennington,8732,8175,557,6.40
MN,Pine,14689,13379,1310,8.90
MN,Pipestone,4711,4513,198,4.20
MN,Polk,16390,15434,956,5.80
MN,Pope,6582,6280,302,4.60
MN,Ramsey,290469,269924,20545,7.10
MN,Red Lake,2244,2094,150,6.70
MN,Redwood,7811,7369,442,5.70
MN,Renville,8540,8034,506,5.90
MN,Rice,37521,35481,2040,5.40
MN,Rock,5864,5679,185,3.20
MN,Roseau,7974,7504,470,5.90
MN,St. Louis,101666,94186,7480,7.40
MN,Scott,85225,80122,5103,6.00
MN,Sherburne,53570,50229,3341,6.20
MN,Sibley,8351,7869,482,5.80
MN,Stearns,91724,86347,5377,5.90
MN,Steele,20658,19505,1153,5.60
MN,Stevens,5466,5283,183,3.30
MN,Swift,4906,4612,294,6.00
MN,Todd,13875,13110,765,5.50
MN,Traverse,1765,1684,81,4.60
MN,Wabasha,12506,11820,686,5.50
MN,Wadena,6054,5571,483,8.00
MN,Waseca,9189,8599,590,6.40
MN,Washington,145942,137581,8361,5.70
MN,Watonwan,6697,6376,321,4.80
MN,Wilkin,3485,3337,148,4.20
MN,Winona,28410,26971,1439,5.10
MN,Wright,77159,72766,4393,5.70
MN,Yellow Medicine,5335,5084,251,4.70
MS,Adams,10429,9310,1119,10.70
MS,Alcorn,15117,14189,928,6.10
MS,Amite,4375,4016,359,8.20
MS,Attala,6840,6280,560,8.20
MS,Benton,2991,2748,243,8.10
MS,Bolivar,11350,10386,964,8.50
MS,Calhoun,5514,5077,437,7.90
MS,Carroll,3391,3134,257,7.60
MS,Chickasaw,6867,6140,727,10.60
MS,Choctaw,3545,3324,221,6.20
MS,Claiborne,3062,2630,432,14.10
MS,Clarke,5701,5230,471,8.30
MS,Clay,7817,6925,892,11.40
MS,Coahoma,8262,7255,1007,12.20
MS,Copiah,10644,9782,862,8.10
MS,Covington,8225,7670,555,6.70
MS,DeSoto,91089,85724,5365,5.90
MS,Forrest,32429,29866,2563,7.90
MS,Franklin,2707,2487,220,8.10
MS,George,8852,8063,789,8.90
MS,Greene,4247,3843,404,9.50
MS,Grenada,9151,8506,645,7.00
MS,Hancock,18566,17037,1529,8.20
MS,Harrison,86485,78493,7992,9.20
MS,Hinds,102032,92650,9382,9.20
MS,Holmes,5440,4576,864,15.90
MS,Humphreys,2181,1866,315,14.40
MS,Issaquena,326,298,28,8.60
MS,Itawamba,10154,9461,693,6.80
MS,Jackson,57693,52314,5379,9.30
MS,Jasper,5972,5449,523,8.80
MS,Jefferson,1957,1605,352,18.00
MS,Jefferson Davis,3944,3573,371,9.40
MS,Jones,25160,23412,1748,6.90
MS,Kemper,3311,3000,311,9.40
MS,Lafayette,26288,24724,1564,5.90
MS,Lamar,30383,28592,1791,5.90
MS,Lauderdale,29215,27065,2150,7.40
MS,Lawrence,4604,4212,392,8.50
MS,Leake,7930,7319,611,7.70
MS,Lee,40820,37573,3247,8.00
MS,Leflore,9760,8741,1019,10.40
MS,Lincoln,14288,13256,1032,7.20
MS,Lowndes,24640,22625,2015,8.20
MS,Madison,52326,48986,3340,6.40
MS,Marion,9988,9293,695,7.00
MS,Marshall,13964,12929,1035,7.40
MS,Monroe,15464,14118,1346,8.70
MS,Montgomery,3860,3556,304,7.90
MS,Neshoba,10246,9313,933,9.10
MS,Newton,7940,7324,616,7.80
MS,Noxubee,3776,3365,411,10.90
MS,Oktibbeha,21799,20156,1643,7.50
MS,Panola,12554,11350,1204,9.60
MS,Pearl River,22926,21303,1623,7.10
MS,Perry,4132,3777,355,8.60
MS,Pike,14404,13142,1262,8.80
MS,Pontotoc,14843,13723,1120,7.50
MS,Prentiss,11038,10290,748,6.80
MS,Quitman,2329,2082,247,10.60
MS,Rankin,74275,70439,3836,5.20
MS,Scott,12433,11718,715,5.80
MS,Sharkey,1451,1296,155,10.70
MS,Simpson,10367,9677,690,6.70
MS,Smith,6540,6170,370,5.70
MS,Stone,6840,6331,509,7.40
MS,Sunflower,7435,6626,809,10.90
MS,Tallahatchie,5089,4716,373,7.30
MS,Tate,11944,11049,895,7.50
MS,Tippah,9182,8552,630,6.90
MS,Tishomingo,8246,7714,532,6.50
MS,Tunica,4432,3775,657,14.80
MS,Union,13932,12960,972,7.00
MS,Walthall,4916,4510,406,8.30
MS,Warren,19904,18206,1698,8.50
MS,Washington,16192,14481,1711,10.60
MS,Wayne,7381,6752,629,8.50
MS,Webster,3837,3559,278,7.20
MS,Wilkinson,2721,2372,349,12.80
MS,Winston,7257,6642,615,8.50
MS,Yalobusha,4841,4469,372,7.70
MS,Yazoo,8964,8067,897,10.00
MO,Adair,10046,9536,510,5.10
MO,Andrew,9712,9324,388,4.00
MO,Atchison,2715,2606,109,4.00
MO,Audrain,10276,9683,593,5.80
MO,Barry,15642,14628,1014,6.50
MO,Barton,5154,4903,251,4.90
MO,Bates,7595,7191,404,5.30
MO,Benton,7212,6687,525,7.30
MO,Bollinger,5364,5064,300,5.60
MO,Boone,95852,91790,4062,4.20
MO,Buchanan,43593,41457,2136,4.90
MO,Butler,18120,16990,1130,6.20
MO,Caldwell,4236,4011,225,5.30
MO,Callaway,21370,20421,949,4.40
MO,Camden,18738,17442,1296,6.90
MO,Cape Girardeau,40375,38321,2054,5.10
MO,Carroll,4611,4357,254,5.50
MO,Carter,2518,2355,163,6.50
MO,Cass,53829,50977,2852,5.30
MO,Cedar,5719,5465,254,4.40
MO,Chariton,3735,3585,150,4.00
MO,Christian,45608,43392,2216,4.90
MO,Clark,3157,2968,189,6.00
MO,Clay,136387,128154,8233,6.00
MO,Clinton,10497,9880,617,5.90
MO,Cole,38765,37065,1700,4.40
MO,Cooper,7155,6767,388,5.40
MO,Crawford,10788,10103,685,6.30
MO,Dade,3549,3396,153,4.30
MO,Dallas,7077,6665,412,5.80
MO,Daviess,4105,3933,172,4.20
MO,DeKalb,4202,4014,188,4.50
MO,Dent,6298,5996,302,4.80
MO,Douglas,5134,4745,389,7.60
MO,Dunklin,11515,10679,836,7.30
MO,Franklin,52536,49318,3218,6.10
MO,Gasconade,7584,7153,431,5.70
MO,Gentry,3392,3278,114,3.40
MO,Greene,149592,141608,7984,5.30
MO,Grundy,4276,4081,195,4.60
MO,Harrison,3786,3615,171,4.50
MO,Henry,9644,9080,564,5.80
MO,Hickory,3866,3673,193,5.00
MO,Holt,2539,2454,85,3.30
MO,Howard,4803,4605,198,4.10
MO,Howell,16188,15108,1080,6.70
MO,Iron,3485,3240,245,7.00
MO,Jackson,356700,331092,25608,7.20
MO,Jasper,55788,52632,3156,5.70
MO,Jefferson,116697,109659,7038,6.00
MO,Johnson,23058,21757,1301,5.60
MO,Knox,1745,1676,69,4.00
MO,Laclede,16704,15346,1358,8.10
MO,Lafayette,16498,15638,860,5.20
MO,Lawrence,17618,16553,1065,6.00
MO,Lewis,4933,4693,240,4.90
MO,Lincoln,29023,27257,1766,6.10
MO,Linn,5048,4738,310,6.10
MO,Livingston,7289,7019,270,3.70
MO,McDonald,10321,9794,527,5.10
MO,Macon,7418,7064,354,4.80
MO,Madison,5452,5099,353,6.50
MO,Maries,3896,3707,189,4.90
MO,Marion,14226,13546,680,4.80
MO,Mercer,1862,1797,65,3.50
MO,Miller,12268,11528,740,6.00
MO,Mississippi,5629,5329,300,5.30
MO,Moniteau,7100,6796,304,4.30
MO,Monroe,3775,3554,221,5.90
MO,Montgomery,5706,5427,279,4.90
MO,Morgan,8202,7693,509,6.20
MO,New Madrid,8397,7910,487,5.80
MO,Newton,26580,25048,1532,5.80
MO,Nodaway,10708,10235,473,4.40
MO,Oregon,3911,3647,264,6.80
MO,Osage,7015,6764,251,3.60
MO,Ozark,3463,3214,249,7.20
MO,Pemiscot,6258,5760,498,8.00
MO,Perry,9809,9269,540,5.50
MO,Pettis,20573,19188,1385,6.70
MO,Phelps,19727,18792,935,4.70
MO,Pike,7458,7059,399,5.30
MO,Platte,58753,55594,3159,5.40
MO,Polk,14290,13623,667,4.70
MO,Pulaski,14524,13708,816,5.60
MO,Putnam,2266,2167,99,4.40
MO,Ralls,5612,5363,249,4.40
MO,Randolph,10119,9523,596,5.90
MO,Ray,10757,10026,731,6.80
MO,Reynolds,2922,2759,163,5.60
MO,Ripley,5007,4617,390,7.80
MO,St. Charles,225229,213631,11598,5.10
MO,St. Clair,3774,3541,233,6.20
MO,Ste. Genevieve,9187,8738,449,4.90
MO,St. Francois,26249,24419,1830,7.00
MO,St. Louis,521403,488660,32743,6.30
MO,Saline,10560,10082,478,4.50
MO,Schuyler,1898,1788,110,5.80
MO,Scotland,2376,2299,77,3.20
MO,Scott,19849,18800,1049,5.30
MO,Shannon,3344,3103,241,7.20
MO,Shelby,3029,2895,134,4.40
MO,Stoddard,13185,12417,768,5.80
MO,Stone,13148,11898,1250,9.50
MO,Sullivan,2752,2634,118,4.30
MO,Taney,25960,22689,3271,12.60
MO,Texas,8938,8425,513,5.70
MO,Vernon,9390,8980,410,4.40
MO,Warren,18539,17492,1047,5.60
MO,Washington,10077,9359,718,7.10
MO,Wayne,5017,4711,306,6.10
MO,Webster,17198,16286,912,5.30
MO,Worth,1170,1122,48,4.10
MO,Wright,7374,6866,508,6.90
MO,St. Louis city,150074,137094,12980,8.60
MT,Beaverhead,5088,4888,200,3.90
MT,Big Horn,4868,4519,349,7.20
MT,Blaine,2271,2164,107,4.70
MT,Broadwater,2650,2486,164,6.20
MT,Carbon,5638,5310,328,5.80
MT,Carter,647,629,18,2.80
MT,Cascade,37907,35719,2188,5.80
MT,Chouteau,2473,2379,94,3.80
MT,Custer,6225,5931,294,4.70
MT,Daniels,891,866,25,2.80
MT,Dawson,4670,4418,252,5.40
MT,Deer Lodge,5073,4820,253,5.00
MT,Fallon,1651,1587,64,3.90
MT,Fergus,5849,5586,263,4.50
MT,Flathead,49750,45934,3816,7.70
MT,Gallatin,70900,67418,3482,4.90
MT,Garfield,746,726,20,2.70
MT,Glacier,5508,4983,525,9.50
MT,Golden Valley,365,348,17,4.70
MT,Granite,1601,1473,128,8.00
MT,Hill,7611,7241,370,4.90
MT,Jefferson,5830,5538,292,5.00
MT,Judith Basin,984,938,46,4.70
MT,Lake,13742,12908,834,6.10
MT,Lewis and Clark,36742,34955,1787,4.90
MT,Liberty,972,946,26,2.70
MT,Lincoln,8119,7308,811,10.00
MT,McCone,959,932,27,2.80
MT,Madison,4686,4454,232,5.00
MT,Meagher,959,915,44,4.60
MT,Mineral,1788,1609,179,10.00
MT,Missoula,64525,60562,3963,6.10
MT,Musselshell,2340,2200,140,6.00
MT,Park,9008,8354,654,7.30
MT,Petroleum,271,262,9,3.30
MT,Phillips,1896,1805,91,4.80
MT,Pondera,2671,2543,128,4.80
MT,Powder River,966,936,30,3.10
MT,Powell,2928,2793,135,4.60
MT,Prairie,471,440,31,6.60
MT,Ravalli,20848,19667,1181,5.70
MT,Richland,5964,5591,373,6.30
MT,Roosevelt,4449,4188,261,5.90
MT,Rosebud,3742,3535,207,5.50
MT,Sanders,5090,4700,390,7.70
MT,Sheridan,1764,1681,83,4.70
MT,Silver Bow,17366,16244,1122,6.50
MT,Stillwater,5374,5108,266,4.90
MT,Sweet Grass,1858,1793,65,3.50
MT,Teton,2791,2672,119,4.30
MT,Toole,2149,2046,103,4.80
MT,Treasure,341,329,12,3.50
MT,Valley,4084,3911,173,4.20
MT,Wheatland,762,709,53,7.00
MT,Wibaux,450,428,22,4.90
MT,Yellowstone,83644,79187,4457,5.30
NE,Adams,17032,16364,668,3.90
NE,Antelope,3932,3847,85,2.20
NE,Arthur,234,222,12,5.10
NE,Banner,392,381,11,2.80
NE,Blaine,255,246,9,3.50
NE,Boone,2954,2882,72,2.40
NE,Box Butte,5404,5155,249,4.60
NE,Boyd,1057,1028,29,2.70
NE,Brown,1422,1384,38,2.70
NE,Buffalo,27865,26768,1097,3.90
NE,Burt,3594,3458,136,3.80
NE,Butler,4624,4470,154,3.30
NE,Cass,13474,12899,575,4.30
NE,Cedar,4563,4442,121,2.70
NE,Chase,2289,2250,39,1.70
NE,Cherry,3400,3318,82,2.40
NE,Cheyenne,4287,4102,185,4.30
NE,Clay,3303,3197,106,3.20
NE,Colfax,5676,5516,160,2.80
NE,Cuming,4890,4769,121,2.50
NE,Custer,6428,6257,171,2.70
NE,Dakota,10716,10212,504,4.70
NE,Dawes,4985,4850,135,2.70
NE,Dawson,13449,13000,449,3.30
NE,Deuel,967,937,30,3.10
NE,Dixon,2957,2862,95,3.20
NE,Dodge,20304,19609,695,3.40
NE,Douglas,302384,287388,14996,5.00
NE,Dundy,1168,1143,25,2.10
NE,Fillmore,3203,3116,87,2.70
NE,Franklin,1480,1431,49,3.30
NE,Frontier,1556,1512,44,2.80
NE,Furnas,2616,2546,70,2.70
NE,Gage,10973,10542,431,3.90
NE,Garden,1082,1044,38,3.50
NE,Garfield,1162,1139,23,2.00
NE,Gosper,1113,1085,28,2.50
NE,Grant,420,412,8,1.90
NE,Greeley,1240,1204,36,2.90
NE,Hall,32215,30403,1812,5.60
NE,Hamilton,4778,4604,174,3.60
NE,Harlan,1753,1704,49,2.80
NE,Hayes,634,620,14,2.20
NE,Hitchcock,1322,1277,45,3.40
NE,Holt,5771,5632,139,2.40
NE,Hooker,410,399,11,2.70
NE,Howard,3403,3258,145,4.30
NE,Jefferson,4236,4123,113,2.70
NE,Johnson,2078,1998,80,3.80
NE,Kearney,3842,3721,121,3.10
NE,Keith,4667,4521,146,3.10
NE,Keya Paha,585,572,13,2.20
NE,Kimball,1986,1917,69,3.50
NE,Knox,4689,4551,138,2.90
NE,Lancaster,178390,171029,7361,4.10
NE,Lincoln,18536,17821,715,3.90
NE,Logan,476,464,12,2.50
NE,Loup,409,396,13,3.20
NE,McPherson,443,432,11,2.50
NE,Madison,19813,19073,740,3.70
NE,Merrick,4082,3925,157,3.80
NE,Morrill,2639,2547,92,3.50
NE,Nance,1975,1913,62,3.10
NE,Nemaha,3625,3498,127,3.50
NE,Nuckolls,2478,2412,66,2.70
NE,Otoe,8451,8157,294,3.50
NE,Pawnee,1503,1463,40,2.70
NE,Perkins,1861,1828,33,1.80
NE,Phelps,5011,4866,145,2.90
NE,Pierce,4176,4044,132,3.20
NE,Platte,17945,17295,650,3.60
NE,Polk,2947,2860,87,3.00
NE,Red Willow,5886,5700,186,3.20
NE,Richardson,4239,4104,135,3.20
NE,Rock,889,871,18,2.00
NE,Saline,7376,7116,260,3.50
NE,Sarpy,97907,93989,3918,4.00
NE,Saunders,11383,10977,406,3.60
NE,Scotts Bluff,18278,17534,744,4.10
NE,Seward,8847,8492,355,4.00
NE,Sheridan,2735,2671,64,2.30
NE,Sherman,1678,1626,52,3.10
NE,Sioux,767,750,17,2.20
NE,Stanton,3556,3441,115,3.20
NE,Thayer,2790,2715,75,2.70
NE,Thomas,430,413,17,4.00
NE,Thurston,3125,2967,158,5.10
NE,Valley,2142,2082,60,2.80
NE,Washington,11268,10865,403,3.60
NE,Wayne,5715,5557,158,2.80
NE,Webster,1663,1602,61,3.70
NE,Wheeler,569,559,10,1.80
NE,York,7327,7086,241,3.30
NV,Churchill,11045,10411,634,5.70
NV,Clark,1104388,932852,171536,15.50
NV,Douglas,22104,20130,1974,8.90
NV,Elko,26086,24551,1535,5.90
NV,Esmeralda,417,395,22,5.30
NV,Eureka,1019,983,36,3.50
NV,Humboldt,8005,7603,402,5.00
NV,Lander,3128,2974,154,4.90
NV,Lincoln,2025,1922,103,5.10
NV,Lyon,22635,20617,2018,8.90
NV,Mineral,2107,1985,122,5.80
NV,Nye,17371,15604,1767,10.20
NV,Pershing,2559,2436,123,4.80
NV,Storey,2009,1838,171,8.50
NV,Washoe,247852,227627,20225,8.20
NV,White Pine,4542,4350,192,4.20
NV,Carson City,25557,23362,2195,8.60
NH,Belknap,30922,28750,2172,7.00
NH,Carroll,22990,21209,1781,7.70
NH,Cheshire,39589,37126,2463,6.20
NH,Coos,14229,13091,1138,8.00
NH,Grafton,47865,45034,2831,5.90
NH,Hillsborough,239777,222896,16881,7.00
NH,Merrimack,82373,77539,4834,5.90
NH,Rockingham,185899,172685,13214,7.10
NH,Strafford,73209,68574,4635,6.30
NH,Sullivan,22917,21664,1253,5.50
NJ,Atlantic,124180,102874,21306,17.20
NJ,Bergen,494483,448791,45692,9.20
NJ,Burlington,239256,220269,18987,7.90
NJ,Camden,264683,238958,25725,9.70
NJ,Cape May,45776,39544,6232,13.60
NJ,Cumberland,68560,61463,7097,10.40
NJ,Essex,387319,343539,43780,11.30
NJ,Gloucester,156923,142899,14024,8.90
NJ,Hudson,373057,334859,38198,10.20
NJ,Hunterdon,65783,61218,4565,6.90
NJ,Mercer,211423,196139,15284,7.20
NJ,Middlesex,447472,409364,38108,8.50
NJ,Monmouth,336908,308005,28903,8.60
NJ,Morris,261110,241500,19610,7.50
NJ,Ocean,289421,263021,26400,9.10
NJ,Passaic,253121,222250,30871,12.20
NJ,Salem,30482,27661,2821,9.30
NJ,Somerset,174041,160966,13075,7.50
NJ,Sussex,76156,69247,6909,9.10
NJ,Union,285238,257873,27365,9.60
NJ,Warren,57556,52839,4717,8.20
NM,Bernalillo,328702,303245,25457,7.70
NM,Catron,1145,1063,82,7.20
NM,Chaves,27617,25452,2165,7.80
NM,Cibola,8968,8168,800,8.90
NM,Colfax,5098,4747,351,6.90
NM,Curry,21910,20749,1161,5.30
NM,De Baca,694,662,32,4.60
NM,Dona Ana,96941,89187,7754,8.00
NM,Eddy,33054,30859,2195,6.60
NM,Grant,11784,10764,1020,8.70
NM,Guadalupe,1493,1395,98,6.60
NM,Harding,276,265,11,4.00
NM,Hidalgo,1913,1805,108,5.60
NM,Lea,29081,25974,3107,10.70
NM,Lincoln,8679,7925,754,8.70
NM,Los Alamos,9788,9432,356,3.60
NM,Luna,10185,8590,1595,15.70
NM,McKinley,23613,21250,2363,10.00
NM,Mora,2032,1873,159,7.80
NM,Otero,25226,23181,2045,8.10
NM,Quay,3035,2816,219,7.20
NM,Rio Arriba,16483,15191,1292,7.80
NM,Roosevelt,7824,7358,466,6.00
NM,Sandoval,66586,61164,5422,8.10
NM,San Juan,50020,45217,4803,9.60
NM,San Miguel,10429,9602,827,7.90
NM,Santa Fe,71037,65447,5590,7.90
NM,Sierra,4068,3704,364,8.90
NM,Socorro,6157,5736,421,6.80
NM,Taos,14705,13068,1637,11.10
NM,Torrance,5322,4835,487,9.20
NM,Union,1628,1547,81,5.00
NM,Valencia,30216,27838,2378,7.90
NY,Albany,159064,148104,10960,6.90
NY,Allegany,19388,17886,1502,7.70
NY,Bronx,617657,517592,100065,16.20
NY,Broome,83341,76405,6936,8.30
NY,Cattaraugus,33626,30565,3061,9.10
NY,Cayuga,36024,33290,2734,7.60
NY,Chautauqua,53821,49233,4588,8.50
NY,Chemung,35912,32893,3019,8.40
NY,Chenango,22117,20650,1467,6.60
NY,Clinton,36090,33328,2762,7.70
NY,Columbia,30869,29034,1835,5.90
NY,Cortland,22779,21027,1752,7.70
NY,Delaware,18957,17637,1320,7.00
NY,Dutchess,144551,133963,10588,7.30
NY,Erie,445070,404444,40626,9.10
NY,Essex,16852,15526,1326,7.90
NY,Franklin,19443,17898,1545,7.90
NY,Fulton,22899,21009,1890,8.30
NY,Genesee,29514,27427,2087,7.10
NY,Greene,20564,18925,1639,8.00
NY,Hamilton,2192,2023,169,7.70
NY,Herkimer,27973,25770,2203,7.90
NY,Jefferson,44090,40387,3703,8.40
NY,Kings,1210703,1057917,152786,12.60
NY,Lewis,11607,10741,866,7.50
NY,Livingston,30254,28189,2065,6.80
NY,Madison,32945,30462,2483,7.50
NY,Monroe,365713,335839,29874,8.20
NY,Montgomery,22442,20553,1889,8.40
NY,Nassau,710248,653335,56913,8.00
NY,New York,902268,815372,86896,9.60
NY,Niagara,99206,89223,9983,10.10
NY,Oneida,102413,94429,7984,7.80
NY,Onondaga,224224,206289,17935,8.00
NY,Ontario,55699,51828,3871,6.90
NY,Orange,186598,171729,14869,8.00
NY,Orleans,17354,15957,1397,8.10
NY,Oswego,52954,48386,4568,8.60
NY,Otsego,27071,25196,1875,6.90
NY,Putnam,51204,47520,3684,7.20
NY,Queens,1150966,1005557,145409,12.60
NY,Rensselaer,81921,76421,5500,6.70
NY,Richmond,223073,199333,23740,10.60
NY,Rockland,155842,143862,11980,7.70
NY,St. Lawrence,43703,40266,3437,7.90
NY,Saratoga,121388,113590,7798,6.40
NY,Schenectady,78220,72204,6016,7.70
NY,Schoharie,14783,13774,1009,6.80
NY,Schuyler,8180,7500,680,8.30
NY,Seneca,15516,14305,1211,7.80
NY,Steuben,42654,39303,3351,7.90
NY,Suffolk,778961,715866,63095,8.10
NY,Sullivan,36460,33409,3051,8.40
NY,Tioga,22528,20836,1692,7.50
NY,Tompkins,49514,46632,2882,5.80
NY,Ulster,87421,80700,6721,7.70
NY,Warren,31372,28821,2551,8.10
NY,Washington,27578,25668,1910,6.90
NY,Wayne,43562,40462,3100,7.10
NY,Westchester,485745,446883,38862,8.00
NY,Wyoming,18181,16866,1315,7.20
NY,Yates,11777,11039,738,6.30
NC,Alamance,78921,73409,5512,7.00
NC,Alexander,17127,15874,1253,7.30
NC,Alleghany,4105,3814,291,7.10
NC,Anson,10100,9351,749,7.40
NC,Ashe,12245,11501,744,6.10
NC,Avery,7095,6660,435,6.10
NC,Beaufort,18841,17684,1157,6.10
NC,Bertie,7377,6922,455,6.20
NC,Bladen,14056,13069,987,7.00
NC,Brunswick,51779,47353,4426,8.50
NC,Buncombe,133508,122736,10772,8.10
NC,Burke,38606,35905,2701,7.00
NC,Cabarrus,107171,99996,7175,6.70
NC,Caldwell,34593,31936,2657,7.70
NC,Camden,4446,4208,238,5.40
NC,Carteret,30331,28486,1845,6.10
NC,Caswell,9390,8684,706,7.50
NC,Catawba,75769,69884,5885,7.80
NC,Chatham,34968,33157,1811,5.20
NC,Cherokee,10654,9832,822,7.70
NC,Chowan,5301,4987,314,5.90
NC,Clay,3973,3687,286,7.20
NC,Cleveland,47102,43522,3580,7.60
NC,Columbus,21929,20209,1720,7.80
NC,Craven,39827,37305,2522,6.30
NC,Cumberland,123636,112350,11286,9.10
NC,Currituck,14055,13214,841,6.00
NC,Dare,19102,17258,1844,9.70
NC,Davidson,77645,72340,5305,6.80
NC,Davie,19763,18470,1293,6.50
NC,Duplin,24090,22781,1309,5.40
NC,Durham,169356,158846,10510,6.20
NC,Edgecombe,19974,17928,2046,10.20
NC,Forsyth,180183,167293,12890,7.20
NC,Franklin,30757,28746,2011,6.50
NC,Gaston,106773,98492,8281,7.80
NC,Gates,4881,4610,271,5.60
NC,Graham,2986,2698,288,9.60
NC,Granville,28903,27275,1628,5.60
NC,Greene,9230,8726,504,5.50
NC,Guilford,252260,231469,20791,8.20
NC,Halifax,19419,17699,1720,8.90
NC,Harnett,51556,47823,3733,7.20
NC,Haywood,28092,26047,2045,7.30
NC,Henderson,51335,47904,3431,6.70
NC,Hertford,8703,8120,583,6.70
NC,Hoke,19476,17863,1613,8.30
NC,Hyde,1748,1572,176,10.10
NC,Iredell,87687,81501,6186,7.10
NC,Jackson,19162,17750,1412,7.40
NC,Johnston,97630,91691,5939,6.10
NC,Jones,4051,3827,224,5.50
NC,Lee,25149,23192,1957,7.80
NC,Lenoir,26729,25135,1594,6.00
NC,Lincoln,42749,40040,2709,6.30
NC,McDowell,19929,18581,1348,6.80
NC,Macon,14970,13993,977,6.50
NC,Madison,9298,8675,623,6.70
NC,Martin,8623,8047,576,6.70
NC,Mecklenburg,606285,561076,45209,7.50
NC,Mitchell,5744,5311,433,7.50
NC,Montgomery,10973,10264,709,6.50
NC,Moore,39542,36751,2791,7.10
NC,Nash,41405,38076,3329,8.00
NC,New Hanover,118291,109989,8302,7.00
NC,Northampton,7214,6701,513,7.10
NC,Onslow,62806,58361,4445,7.10
NC,Orange,76310,72369,3941,5.20
NC,Pamlico,5156,4878,278,5.40
NC,Pasquotank,16085,14941,1144,7.10
NC,Pender,27830,26077,1753,6.30
NC,Perquimans,4729,4417,312,6.60
NC,Person,17853,16597,1256,7.00
NC,Pitt,85632,80018,5614,6.60
NC,Polk,8719,8192,527,6.00
NC,Randolph,62845,58373,4472,7.10
NC,Richmond,16160,14727,1433,8.90
NC,Robeson,48256,44128,4128,8.60
NC,Rockingham,38146,35071,3075,8.10
NC,Rowan,63077,58194,4883,7.70
NC,Rutherford,23751,21603,2148,9.00
NC,Sampson,27558,25999,1559,5.70
NC,Scotland,11008,9722,1286,11.70
NC,Stanly,28880,27112,1768,6.10
NC,Stokes,20523,19248,1275,6.20
NC,Surry,31730,29615,2115,6.70
NC,Swain,6745,6188,557,8.30
NC,Transylvania,13757,12938,819,6.00
NC,Tyrrell,1234,1122,112,9.10
NC,Union,119383,112507,6876,5.80
NC,Vance,16542,14921,1621,9.80
NC,Wake,572430,536715,35715,6.20
NC,Warren,6322,5721,601,9.50
NC,Washington,4249,3914,335,7.90
NC,Watauga,27087,25442,1645,6.10
NC,Wayne,49707,46620,3087,6.20
NC,Wilkes,27476,25654,1822,6.60
NC,Wilson,33578,30693,2885,8.60
NC,Yadkin,16849,15687,1162,6.90
NC,Yancey,7920,7410,510,6.40
ND,Adams,1011,973,38,3.80
ND,Barnes,5211,5010,201,3.90
ND,Benson,2321,2163,158,6.80
ND,Billings,439,423,16,3.60
ND,Bottineau,2985,2825,160,5.40
ND,Bowman,1635,1580,55,3.40
ND,Burke,1039,984,55,5.30
ND,Burleigh,51298,49088,2210,4.30
ND,Cass,106255,101632,4623,4.40
ND,Cavalier,1915,1849,66,3.40
ND,Dickey,2316,2240,76,3.30
ND,Divide,1445,1399,46,3.20
ND,Dunn,3162,3016,146,4.60
ND,Eddy,1206,1150,56,4.60
ND,Emmons,1494,1422,72,4.80
ND,Foster,1562,1508,54,3.50
ND,Golden Valley,865,838,27,3.10
ND,Grand Forks,37296,35591,1705,4.60
ND,Grant,1202,1169,33,2.70
ND,Griggs,1027,996,31,3.00
ND,Hettinger,1398,1342,56,4.00
ND,Kidder,1301,1235,66,5.10
ND,LaMoure,2071,2016,55,2.70
ND,Logan,864,836,28,3.20
ND,McHenry,3122,2953,169,5.40
ND,McIntosh,1102,1066,36,3.30
ND,McKenzie,9537,8811,726,7.60
ND,McLean,4850,4632,218,4.50
ND,Mercer,3653,3443,210,5.70
ND,Morton,16964,16112,852,5.00
ND,Mountrail,6941,6579,362,5.20
ND,Nelson,1403,1340,63,4.50
ND,Oliver,875,830,45,5.10
ND,Pembina,3405,3215,190,5.60
ND,Pierce,1715,1642,73,4.30
ND,Ramsey,5754,5499,255,4.40
ND,Ransom,2898,2782,116,4.00
ND,Renville,1235,1174,61,4.90
ND,Richland,8656,8325,331,3.80
ND,Rolette,4804,4154,650,13.50
ND,Sargent,2813,2694,119,4.20
ND,Sheridan,683,643,40,5.90
ND,Sioux,1200,1152,48,4.00
ND,Slope,395,383,12,3.00
ND,Stark,18471,17132,1339,7.20
ND,Steele,963,935,28,2.90
ND,Stutsman,10575,10209,366,3.50
ND,Towner,1159,1126,33,2.80
ND,Traill,4483,4322,161,3.60
ND,Walsh,5187,4953,234,4.50
ND,Ward,32163,30237,1926,6.00
ND,Wells,1918,1835,83,4.30
ND,Williams,23314,21042,2272,9.70
OH,Adams,10860,9850,1010,9.30
OH,Allen,47786,43690,4096,8.60
OH,Ashland,26265,24564,1701,6.50
OH,Ashtabula,43647,40010,3637,8.30
OH,Athens,26343,24334,2009,7.60
OH,Auglaize,24501,22818,1683,6.90
OH,Belmont,28503,25610,2893,10.10
OH,Brown,19237,17633,1604,8.30
OH,Butler,193517,179442,14075,7.30
OH,Carroll,12842,11708,1134,8.80
OH,Champaign,19780,18366,1414,7.10
OH,Clark,62600,57507,5093,8.10
OH,Clermont,105768,98483,7285,6.90
OH,Clinton,17676,16197,1479,8.40
OH,Columbiana,47034,42612,4422,9.40
OH,Coshocton,14090,12834,1256,8.90
OH,Crawford,18526,16795,1731,9.30
OH,Cuyahoga,597091,533399,63692,10.70
OH,Darke,25651,23923,1728,6.70
OH,Defiance,17726,16274,1452,8.20
OH,Delaware,112091,106072,6019,5.40
OH,Erie,36454,32666,3788,10.40
OH,Fairfield,78558,73344,5214,6.60
OH,Fayette,13938,12909,1029,7.40
OH,Franklin,699903,647092,52811,7.50
OH,Fulton,21739,20025,1714,7.90
OH,Gallia,12199,11223,976,8.00
OH,Geauga,46661,43470,3191,6.80
OH,Greene,82426,77103,5323,6.50
OH,Guernsey,18252,16664,1588,8.70
OH,Hamilton,412480,380073,32407,7.90
OH,Hancock,41424,38600,2824,6.80
OH,Hardin,13917,12789,1128,8.10
OH,Harrison,6681,6061,620,9.30
OH,Henry,12998,11945,1053,8.10
OH,Highland,17396,15886,1510,8.70
OH,Hocking,12713,11760,953,7.50
OH,Holmes,20880,20064,816,3.90
OH,Huron,27495,24892,2603,9.50
OH,Jackson,13123,11975,1148,8.70
OH,Jefferson,27420,24650,2770,10.10
OH,Knox,30907,28987,1920,6.20
OH,Lake,121960,111570,10390,8.50
OH,Lawrence,23638,21626,2012,8.50
OH,Licking,90081,84147,5934,6.60
OH,Logan,22699,20836,1863,8.20
OH,Lorain,151801,136706,15095,9.90
OH,Lucas,208080,186564,21516,10.30
OH,Madison,20485,19253,1232,6.00
OH,Mahoning,100152,89923,10229,10.20
OH,Marion,28244,26098,2146,7.60
OH,Medina,94989,87686,7303,7.70
OH,Meigs,8968,8095,873,9.70
OH,Mercer,23380,22124,1256,5.40
OH,Miami,53894,50121,3773,7.00
OH,Monroe,5656,5051,605,10.70
OH,Montgomery,251066,229324,21742,8.70
OH,Morgan,6682,6065,617,9.20
OH,Morrow,16706,15504,1202,7.20
OH,Muskingum,40198,37072,3126,7.80
OH,Noble,4636,4186,450,9.70
OH,Ottawa,20566,18690,1876,9.10
OH,Paulding,8681,8033,648,7.50
OH,Perry,15786,14447,1339,8.50
OH,Pickaway,26263,24464,1799,6.80
OH,Pike,10857,9837,1020,9.40
OH,Portage,85380,79156,6224,7.30
OH,Preble,21014,19589,1425,6.80
OH,Putnam,18530,17493,1037,5.60
OH,Richland,51670,47026,4644,9.00
OH,Ross,35186,32371,2815,8.00
OH,Sandusky,29980,27548,2432,8.10
OH,Scioto,29082,26546,2536,8.70
OH,Seneca,27108,24912,2196,8.10
OH,Shelby,23940,22093,1847,7.70
OH,Stark,183250,168443,14807,8.10
OH,Summit,267963,245734,22229,8.30
OH,Trumbull,84667,75860,8807,10.40
OH,Tuscarawas,44452,41095,3357,7.60
OH,Union,29513,27803,1710,5.80
OH,Van Wert,14734,13699,1035,7.00
OH,Vinton,5599,5083,516,9.20
OH,Warren,119580,111968,7612,6.40
OH,Washington,26808,24503,2305,8.60
OH,Wayne,60299,56754,3545,5.90
OH,Williams,18782,17330,1452,7.70
OH,Wood,69186,64309,4877,7.00
OH,Wyandot,12893,12001,892,6.90
OK,Adair,8260,7771,489,5.90
OK,Alfalfa,2746,2645,101,3.70
OK,Atoka,5113,4745,368,7.20
OK,Beaver,2570,2501,69,2.70
OK,Beckham,9942,9179,763,7.70
OK,Blaine,4375,4110,265,6.10
OK,Bryan,22318,21168,1150,5.20
OK,Caddo,11894,11180,714,6.00
OK,Canadian,77282,72687,4595,5.90
OK,Carter,21239,19729,1510,7.10
OK,Cherokee,19489,18401,1088,5.60
OK,Choctaw,5552,5128,424,7.60
OK,Cimarron,1397,1368,29,2.10
OK,Cleveland,142056,134026,8030,5.70
OK,Coal,2275,2117,158,6.90
OK,Comanche,47820,44578,3242,6.80
OK,Cotton,2704,2511,193,7.10
OK,Craig,5785,5468,317,5.50
OK,Creek,30901,28850,2051,6.60
OK,Custer,15019,14197,822,5.50
OK,Delaware,18276,17287,989,5.40
OK,Dewey,2676,2545,131,4.90
OK,Ellis,2129,2032,97,4.60
OK,Garfield,26854,25369,1485,5.50
OK,Garvin,12694,11894,800,6.30
OK,Grady,26284,24650,1634,6.20
OK,Grant,2760,2667,93,3.40
OK,Greer,1867,1725,142,7.60
OK,Harmon,1168,1126,42,3.60
OK,Harper,1763,1702,61,3.50
OK,Haskell,4216,3877,339,8.00
OK,Hughes,5295,4892,403,7.60
OK,Jackson,10567,10131,436,4.10
OK,Jefferson,2554,2384,170,6.70
OK,Johnston,3743,3454,289,7.70
OK,Kay,18245,17017,1228,6.70
OK,Kingfisher,8721,8336,385,4.40
OK,Kiowa,3499,3320,179,5.10
OK,Latimer,3138,2816,322,10.30
OK,Le Flore,19023,17673,1350,7.10
OK,Lincoln,15458,14577,881,5.70
OK,Logan,22227,21070,1157,5.20
OK,Love,6495,6218,277,4.30
OK,McClain,19999,18886,1113,5.60
OK,McCurtain,14944,13932,1012,6.80
OK,McIntosh,7105,6496,609,8.60
OK,Major,3668,3491,177,4.80
OK,Marshall,6802,6356,446,6.60
OK,Mayes,19241,18247,994,5.20
OK,Murray,6110,5728,382,6.30
OK,Muskogee,28999,27213,1786,6.20
OK,Noble,5451,5225,226,4.10
OK,Nowata,4588,4343,245,5.30
OK,Okfuskee,4388,4090,298,6.80
OK,Oklahoma,383293,358408,24885,6.50
OK,Okmulgee,15323,14185,1138,7.40
OK,Osage,20130,18796,1334,6.60
OK,Ottawa,14226,13408,818,5.80
OK,Pawnee,7223,6742,481,6.70
OK,Payne,37540,35533,2007,5.30
OK,Pittsburg,16610,15332,1278,7.70
OK,Pontotoc,19111,18110,1001,5.20
OK,Pottawatomie,32172,30179,1993,6.20
OK,Pushmataha,4443,4143,300,6.80
OK,Roger Mills,1773,1682,91,5.10
OK,Rogers,44609,41984,2625,5.90
OK,Seminole,9170,8479,691,7.50
OK,Sequoyah,16378,15242,1136,6.90
OK,Stephens,18430,16974,1456,7.90
OK,Texas,11246,10982,264,2.30
OK,Tillman,3018,2827,191,6.30
OK,Tulsa,322431,301019,21412,6.60
OK,Wagoner,38363,36111,2252,5.90
OK,Washington,22159,20841,1318,5.90
OK,Washita,5082,4735,347,6.80
OK,Woods,4580,4421,159,3.50
OK,Woodward,8881,8271,610,6.90
OR,Baker,7269,6747,522,7.20
OR,Benton,46653,44036,2617,5.60
OR,Clackamas,218357,202544,15813,7.20
OR,Clatsop,19269,17441,1828,9.50
OR,Columbia,24130,22221,1909,7.90
OR,Coos,26580,24285,2295,8.60
OR,Crook,10369,9454,915,8.80
OR,Curry,8961,8183,778,8.70
OR,Deschutes,98204,90396,7808,8.00
OR,Douglas,47323,43658,3665,7.70
OR,Gilliam,992,930,62,6.30
OR,Grant,3201,2933,268,8.40
OR,Harney,3635,3420,215,5.90
OR,Hood River,14100,13215,885,6.30
OR,Jackson,105118,96906,8212,7.80
OR,Jefferson,10321,9470,851,8.20
OR,Josephine,36117,33262,2855,7.90
OR,Klamath,29519,26952,2567,8.70
OR,Lake,3656,3450,206,5.60
OR,Lane,179141,165033,14108,7.90
OR,Lincoln,20757,18505,2252,10.80
OR,Linn,59127,54551,4576,7.70
OR,Malheur,12578,11918,660,5.20
OR,Marion,162560,151236,11324,7.00
OR,Morrow,5770,5473,297,5.10
OR,Multnomah,456024,416679,39345,8.60
OR,Polk,40644,37994,2650,6.50
OR,Sherman,977,916,61,6.20
OR,Tillamook,11862,10910,952,8.00
OR,Umatilla,36986,34480,2506,6.80
OR,Union,12014,11072,942,7.80
OR,Wallowa,3462,3216,246,7.10
OR,Wasco,13452,12498,954,7.10
OR,Washington,320607,299729,20878,6.50
OR,Wheeler,694,664,30,4.30
OR,Yamhill,54131,50468,3663,6.80
PA,Adams,54605,50835,3770,6.90
PA,Allegheny,644176,585953,58223,9.00
PA,Armstrong,31723,28603,3120,9.80
PA,Beaver,83688,75060,8628,10.30
PA,Bedford,23950,21791,2159,9.00
PA,Berks,214967,194595,20372,9.50
PA,Blair,60042,54823,5219,8.70
PA,Bradford,28471,26329,2142,7.50
PA,Bucks,343462,315041,28421,8.30
PA,Butler,99378,91640,7738,7.80
PA,Cambria,56988,51562,5426,9.50
PA,Cameron,2065,1807,258,12.50
PA,Carbon,31966,28839,3127,9.80
PA,Centre,77577,73057,4520,5.80
PA,Chester,285148,266873,18275,6.40
PA,Clarion,16995,15585,1410,8.30
PA,Clearfield,36093,32772,3321,9.20
PA,Clinton,17910,16349,1561,8.70
PA,Columbia,33784,31042,2742,8.10
PA,Crawford,38660,35224,3436,8.90
PA,Cumberland,133054,124212,8842,6.60
PA,Dauphin,146534,133508,13026,8.90
PA,Delaware,298936,271519,27417,9.20
PA,Elk,15420,13546,1874,12.20
PA,Erie,128723,116100,12623,9.80
PA,Fayette,56830,50131,6699,11.80
PA,Forest,1815,1623,192,10.60
PA,Franklin,78502,72545,5957,7.60
PA,Fulton,7504,6609,895,11.90
PA,Greene,16153,14579,1574,9.70
PA,Huntingdon,19826,17736,2090,10.50
PA,Indiana,38132,34661,3471,9.10
PA,Jefferson,20351,18565,1786,8.80
PA,Juniata,12745,11830,915,7.20
PA,Lackawanna,105010,94896,10114,9.60
PA,Lancaster,285487,264119,21368,7.50
PA,Lawrence,40785,36557,4228,10.40
PA,Lebanon,72985,67204,5781,7.90
PA,Lehigh,194736,176099,18637,9.60
PA,Luzerne,159443,141990,17453,10.90
PA,Lycoming,56760,51752,5008,8.80
PA,McKean,17323,15621,1702,9.80
PA,Mercer,48710,43991,4719,9.70
PA,Mifflin,21331,19526,1805,8.50
PA,Monroe,82783,73276,9507,11.50
PA,Montgomery,454869,420355,34514,7.60
PA,Montour,9096,8531,565,6.20
PA,Northampton,161346,146914,14432,8.90
PA,Northumberland,42800,38777,4023,9.40
PA,Perry,24330,22681,1649,6.80
PA,Philadelphia/city,736067,644480,91587,12.40
PA,Pike,25415,22737,2678,10.50
PA,Potter,7289,6607,682,9.40
PA,Schuylkill,66976,60768,6208,9.30
PA,Snyder,19648,18143,1505,7.70
PA,Somerset,33152,30019,3133,9.50
PA,Sullivan,2614,2391,223,8.50
PA,Susquehanna,20029,18558,1471,7.30
PA,Tioga,19110,17382,1728,9.00
PA,Union,19552,18234,1318,6.70
PA,Venango,22410,20410,2000,8.90
PA,Warren,18862,17332,1530,8.10
PA,Washington,106805,96787,10018,9.40
PA,Wayne,22391,20338,2053,9.20
PA,Westmoreland,178773,162500,16273,9.10
PA,Wyoming,13340,12215,1125,8.40
PA,York,236371,217448,18923,8.00
RI,Bristol,26049,24111,1938,7.40
RI,Kent,92814,84857,7957,8.60
RI,Newport,44473,40912,3561,8.00
RI,Providence,334632,301230,33402,10.00
RI,Washington,69088,63803,5285,7.60
SC,Abbeville,9736,9107,629,6.50
SC,Aiken,73641,70057,3584,4.90
SC,Allendale,2547,2310,237,9.30
SC,Anderson,88440,83340,5100,5.80
SC,Bamberg,4742,4327,415,8.80
SC,Barnwell,7750,7193,557,7.20
SC,Beaufort,74689,70743,3946,5.30
SC,Berkeley,104073,98469,5604,5.40
SC,Calhoun,6339,5960,379,6.00
SC,Charleston,206334,193644,12690,6.20
SC,Cherokee,24736,22807,1929,7.80
SC,Chester,13154,11997,1157,8.80
SC,Chesterfield,21298,20043,1255,5.90
SC,Clarendon,12438,11621,817,6.60
SC,Colleton,16233,15272,961,5.90
SC,Darlington,29821,27944,1877,6.30
SC,Dillon,12929,12156,773,6.00
SC,Dorchester,75805,71521,4284,5.70
SC,Edgefield,10352,9833,519,5.00
SC,Fairfield,9182,8462,720,7.80
SC,Florence,65409,61858,3551,5.40
SC,Georgetown,25508,23643,1865,7.30
SC,Greenville,251085,237271,13814,5.50
SC,Greenwood,30692,28785,1907,6.20
SC,Hampton,7975,7594,381,4.80
SC,Horry,144273,132169,12104,8.40
SC,Jasper,12780,12147,633,5.00
SC,Kershaw,28830,27342,1488,5.20
SC,Lancaster,42172,39386,2786,6.60
SC,Laurens,29285,27330,1955,6.70
SC,Lee,6652,6157,495,7.40
SC,Lexington,147607,141382,6225,4.20
SC,McCormick,3273,3061,212,6.50
SC,Marion,12937,11953,984,7.60
SC,Marlboro,9051,8194,857,9.50
SC,Newberry,18800,17929,871,4.60
SC,Oconee,34191,32421,1770,5.20
SC,Orangeburg,33961,30969,2992,8.80
SC,Pickens,55575,52706,2869,5.20
SC,Richland,194203,183126,11077,5.70
SC,Saluda,8320,7973,347,4.20
SC,Spartanburg,155678,145822,9856,6.30
SC,Sumter,42871,40077,2794,6.50
SC,Union,11431,10413,1018,8.90
SC,Williamsburg,11463,10541,922,8.00
SC,York,142608,134279,8329,5.80
SD,Aurora,1463,1419,44,3.00
SD,Beadle,9306,8971,335,3.60
SD,Bennett,1070,1019,51,4.80
SD,Bon Homme,2837,2729,108,3.80
SD,Brookings,18406,17649,757,4.10
SD,Brown,20458,19617,841,4.10
SD,Brule,2456,2354,102,4.20
SD,Buffalo,687,635,52,7.60
SD,Butte,4961,4711,250,5.00
SD,Campbell,780,754,26,3.30
SD,Charles Mix,3754,3531,223,5.90
SD,Clark,2142,2062,80,3.70
SD,Clay,7113,6810,303,4.30
SD,Codington,15370,14665,705,4.60
SD,Corson,1316,1255,61,4.60
SD,Custer,4026,3796,230,5.70
SD,Davison,10874,10449,425,3.90
SD,Day,2680,2537,143,5.30
SD,Deuel,2313,2198,115,5.00
SD,Dewey,2294,2133,161,7.00
SD,Douglas,1542,1500,42,2.70
SD,Edmunds,1978,1924,54,2.70
SD,Fall River,2996,2828,168,5.60
SD,Faulk,1030,996,34,3.30
SD,Grant,4344,4181,163,3.80
SD,Gregory,2030,1958,72,3.50
SD,Haakon,1051,1026,25,2.40
SD,Hamlin,3344,3236,108,3.20
SD,Hand,1739,1696,43,2.50
SD,Hanson,1749,1665,84,4.80
SD,Harding,716,692,24,3.40
SD,Hughes,9818,9511,307,3.10
SD,Hutchinson,3588,3461,127,3.50
SD,Hyde,666,646,20,3.00
SD,Jackson,1201,1153,48,4.00
SD,Jerauld,1190,1163,27,2.30
SD,Jones,519,501,18,3.50
SD,Kingsbury,2660,2568,92,3.50
SD,Lake,6426,6196,230,3.60
SD,Lawrence,13488,12703,785,5.80
SD,Lincoln,36033,34811,1222,3.40
SD,Lyman,1658,1568,90,5.40
SD,McCook,2978,2874,104,3.50
SD,McPherson,990,942,48,4.80
SD,Marshall,2406,2299,107,4.40
SD,Meade,13789,13146,643,4.70
SD,Mellette,708,666,42,5.90
SD,Miner,1141,1090,51,4.50
SD,Minnehaha,112711,107919,4792,4.30
SD,Moody,4000,3806,194,4.90
SD,Oglala Lakota,3765,3418,347,9.20
SD,Pennington,57063,54232,2831,5.00
SD,Perkins,1365,1318,47,3.40
SD,Potter,1018,987,31,3.00
SD,Roberts,4797,4511,286,6.00
SD,Sanborn,1154,1110,44,3.80
SD,Spink,3075,2959,116,3.80
SD,Stanley,1903,1834,69,3.60
SD,Sully,787,766,21,2.70
SD,Todd,3043,2858,185,6.10
SD,Tripp,2984,2897,87,2.90
SD,Turner,4550,4380,170,3.70
SD,Union,8597,8191,406,4.70
SD,Walworth,2116,1995,121,5.70
SD,Yankton,11676,11175,501,4.30
SD,Ziebach,942,902,40,4.20
TN,Anderson,34328,32035,2293,6.70
TN,Bedford,21043,19377,1666,7.90
TN,Benton,6782,6248,534,7.90
TN,Bledsoe,4290,3931,359,8.40
TN,Blount,63745,59710,4035,6.30
TN,Bradley,52569,49146,3423,6.50
TN,Campbell,14587,13489,1098,7.50
TN,Cannon,6525,6102,423,6.50
TN,Carroll,11426,10583,843,7.40
TN,Carter,23679,22074,1605,6.80
TN,Cheatham,21366,20160,1206,5.60
TN,Chester,8473,8007,466,5.50
TN,Claiborne,12786,11840,946,7.40
TN,Clay,2704,2495,209,7.70
TN,Cocke,14864,13333,1531,10.30
TN,Coffee,25676,23646,2030,7.90
TN,Crockett,6828,6438,390,5.70
TN,Cumberland,22789,21080,1709,7.50
TN,Davidson,399262,366706,32556,8.20
TN,Decatur,4442,4062,380,8.60
TN,DeKalb,7675,6981,694,9.00
TN,Dickson,26347,24786,1561,5.90
TN,Dyer,15910,14659,1251,7.90
TN,Fayette,19197,18015,1182,6.20
TN,Fentress,7520,7052,468,6.20
TN,Franklin,19902,18311,1591,8.00
TN,Gibson,21800,20334,1466,6.70
TN,Giles,14640,13427,1213,8.30
TN,Grainger,9491,8818,673,7.10
TN,Greene,28894,26558,2336,8.10
TN,Grundy,5127,4620,507,9.90
TN,Hamblen,27937,25970,1967,7.00
TN,Hamilton,183042,170177,12865,7.00
TN,Hancock,2195,2016,179,8.20
TN,Hardeman,9286,8556,730,7.90
TN,Hardin,10260,9553,707,6.90
TN,Hawkins,23389,21605,1784,7.60
TN,Haywood,7775,7107,668,8.60
TN,Henderson,11889,10939,950,8.00
TN,Henry,14139,13146,993,7.00
TN,Hickman,11100,10458,642,5.80
TN,Houston,3246,2995,251,7.70
TN,Humphreys,8692,8160,532,6.10
TN,Jackson,4716,4345,371,7.90
TN,Jefferson,24946,23080,1866,7.50
TN,Johnson,7682,7202,480,6.20
TN,Knox,243232,229028,14204,5.80
TN,Lake,1679,1544,135,8.00
TN,Lauderdale,9690,8847,843,8.70
TN,Lawrence,19255,17774,1481,7.70
TN,Lewis,5343,4944,399,7.50
TN,Lincoln,15974,14633,1341,8.40
TN,Loudon,23711,22242,1469,6.20
TN,McMinn,23319,21510,1809,7.80
TN,McNairy,8355,7660,695,8.30
TN,Macon,11162,10440,722,6.50
TN,Madison,49371,45711,3660,7.40
TN,Marion,12271,11352,919,7.50
TN,Marshall,15479,14074,1405,9.10
TN,Maury,51074,46981,4093,8.00
TN,Meigs,5193,4745,448,8.60
TN,Monroe,20157,18549,1608,8.00
TN,Montgomery,86946,80428,6518,7.50
TN,Moore,3613,3421,192,5.30
TN,Morgan,7583,7106,477,6.30
TN,Obion,12168,11351,817,6.70
TN,Overton,9740,9129,611,6.30
TN,Perry,2962,2679,283,9.60
TN,Pickett,2237,2103,134,6.00
TN,Polk,7384,6883,501,6.80
TN,Putnam,35093,32839,2254,6.40
TN,Rhea,13115,11861,1254,9.60
TN,Roane,22969,21521,1448,6.30
TN,Robertson,37208,34951,2257,6.10
TN,Rutherford,186794,173859,12935,6.90
TN,Scott,8149,7467,682,8.40
TN,Sequatchie,6166,5690,476,7.70
TN,Sevier,54099,48842,5257,9.70
TN,Shelby,447173,404828,42345,9.50
TN,Smith,9240,8683,557,6.00
TN,Stewart,5411,5070,341,6.30
TN,Sullivan,69267,64374,4893,7.10
TN,Sumner,103421,96746,6675,6.50
TN,Tipton,27619,25795,1824,6.60
TN,Trousdale,5426,5089,337,6.20
TN,Unicoi,7020,6468,552,7.90
TN,Union,7628,7110,518,6.80
TN,Van Buren,2014,1843,171,8.50
TN,Warren,17232,15712,1520,8.80
TN,Washington,60313,56528,3785,6.30
TN,Wayne,6356,5924,432,6.80
TN,Weakley,15467,14587,880,5.70
TN,White,12068,11221,847,7.00
TN,Williamson,129427,123362,6065,4.70
TN,Wilson,77895,72992,4903,6.30
TX,Anderson,22869,21569,1300,5.70
TX,Andrews,9127,8378,749,8.20
TX,Angelina,35185,32500,2685,7.60
TX,Aransas,9103,8342,761,8.40
TX,Archer,3942,3735,207,5.30
TX,Armstrong,891,853,38,4.30
TX,Atascosa,21480,19645,1835,8.50
TX,Austin,13362,12474,888,6.60
TX,Bailey,2369,2256,113,4.80
TX,Bandera,9872,9298,574,5.80
TX,Bastrop,42433,39877,2556,6.00
TX,Baylor,1756,1696,60,3.40
TX,Bee,9748,8781,967,9.90
TX,Bell,143703,133640,10063,7.00
TX,Bexar,927557,856813,70744,7.60
TX,Blanco,6530,6279,251,3.80
TX,Borden,438,423,15,3.40
TX,Bosque,8185,7738,447,5.50
TX,Bowie,38412,35569,2843,7.40
TX,Brazoria,177312,162103,15209,8.60
TX,Brazos,116321,110128,6193,5.30
TX,Brewster,4069,3800,269,6.60
TX,Briscoe,549,523,26,4.70
TX,Brooks,2571,2297,274,10.70
TX,Brown,15123,14143,980,6.50
TX,Burleson,8074,7560,514,6.40
TX,Burnet,23517,22399,1118,4.80
TX,Caldwell,18814,17593,1221,6.50
TX,Calhoun,11845,11155,690,5.80
TX,Callahan,5942,5619,323,5.40
TX,Cameron,169311,152198,17113,10.10
TX,Camp,4952,4586,366,7.40
TX,Carson,2854,2734,120,4.20
TX,Cass,12132,11172,960,7.90
TX,Castro,3249,3131,118,3.60
TX,Chambers,20207,18316,1891,9.40
TX,Cherokee,20980,19316,1664,7.90
TX,Childress,2995,2884,111,3.70
TX,Clay,4772,4508,264,5.50
TX,Cochran,1105,1026,79,7.10
TX,Coke,1353,1279,74,5.50
TX,Coleman,2844,2635,209,7.30
TX,Collin,575879,539871,36008,6.30
TX,Collingsworth,1061,1016,45,4.20
TX,Colorado,9604,9070,534,5.60
TX,Comal,76810,72136,4674,6.10
TX,Comanche,5584,5277,307,5.50
TX,Concho,1321,1262,59,4.50
TX,Cooke,19111,17756,1355,7.10
TX,Coryell,23634,22070,1564,6.60
TX,Cottle,564,536,28,5.00
TX,Crane,1613,1393,220,13.60
TX,Crockett,1538,1401,137,8.90
TX,Crosby,2277,2156,121,5.30
TX,Culberson,1120,1046,74,6.60
TX,Dallam,3708,3606,102,2.80
TX,Dallas,1322606,1219627,102979,7.80
TX,Dawson,4541,4145,396,8.70
TX,Deaf Smith,8430,8126,304,3.60
TX,Delta,2377,2246,131,5.50
TX,Denton,508668,475991,32677,6.40
TX,DeWitt,9128,8575,553,6.10
TX,Dickens,656,615,41,6.30
TX,Dimmit,6428,6019,409,6.40
TX,Donley,1405,1343,62,4.40
TX,Duval,4799,4215,584,12.20
TX,Eastland,7280,6790,490,6.70
TX,Ector,82119,73046,9073,11.00
TX,Edwards,1228,1185,43,3.50
TX,Ellis,94566,88922,5644,6.00
TX,El Paso,359563,329749,29814,8.30
TX,Erath,19821,18684,1137,5.70
TX,Falls,6346,5959,387,6.10
TX,Fannin,16589,15806,783,4.70
TX,Fayette,11674,11124,550,4.70
TX,Fisher,1584,1513,71,4.50
TX,Floyd,2477,2323,154,6.20
TX,Foard,571,548,23,4.00
TX,Fort Bend,400509,369972,30537,7.60
TX,Franklin,4785,4529,256,5.40
TX,Freestone,6278,5754,524,8.30
TX,Frio,9467,8930,537,5.70
TX,Gaines,9644,9101,543,5.60
TX,Galveston,162980,148692,14288,8.80
TX,Garza,1995,1859,136,6.80
TX,Gillespie,13152,12527,625,4.80
TX,Glasscock,798,769,29,3.60
TX,Goliad,3107,2865,242,7.80
TX,Gonzales,9442,8931,511,5.40
TX,Gray,7705,7079,626,8.10
TX,Grayson,63568,59830,3738,5.90
TX,Gregg,55968,51319,4649,8.30
TX,Grimes,11007,10118,889,8.10
TX,Guadalupe,80164,75248,4916,6.10
TX,Hale,11636,10850,786,6.80
TX,Hall,1057,996,61,5.80
TX,Hamilton,3709,3540,169,4.60
TX,Hansford,2459,2373,86,3.50
TX,Hardeman,1692,1618,74,4.40
TX,Hardin,25055,22819,2236,8.90
TX,Harris,2263260,2060208,203052,9.00
TX,Harrison,28818,26551,2267,7.90
TX,Hartley,2594,2543,51,2.00
TX,Haskell,2650,2537,113,4.30
TX,Hays,122675,114991,7684,6.30
TX,Hemphill,1780,1699,81,4.60
TX,Henderson,36798,34432,2366,6.40
TX,Hidalgo,357301,315643,41658,11.70
TX,Hill,16151,15133,1018,6.30
TX,Hockley,10583,9741,842,8.00
TX,Hood,27778,25945,1833,6.60
TX,Hopkins,17334,16449,885,5.10
TX,Houston,10001,9477,524,5.20
TX,Howard,13341,12257,1084,8.10
TX,Hudspeth,1834,1685,149,8.10
TX,Hunt,42940,40114,2826,6.60
TX,Hutchinson,8436,7832,604,7.20
TX,Irion,752,707,45,6.00
TX,Jack,3370,3134,236,7.00
TX,Jackson,7228,6810,418,5.80
TX,Jasper,12751,11320,1431,11.20
TX,Jeff Davis,953,904,49,5.10
TX,Jefferson,104025,91569,12456,12.00
TX,Jim Hogg,1863,1685,178,9.60
TX,Jim Wells,15997,13919,2078,13.00
TX,Johnson,82833,77464,5369,6.50
TX,Jones,5585,5190,395,7.10
TX,Karnes,6944,6508,436,6.30
TX,Kaufman,68859,64465,4394,6.40
TX,Kendall,22016,20900,1116,5.10
TX,Kenedy,179,169,10,5.60
TX,Kent,459,441,18,3.90
TX,Kerr,21535,20277,1258,5.80
TX,Kimble,1818,1727,91,5.00
TX,King,234,230,4,1.70
TX,Kinney,1300,1223,77,5.90
TX,Kleberg,13142,12030,1112,8.50
TX,Knox,1438,1357,81,5.60
TX,Lamar,23378,21875,1503,6.40
TX,Lamb,5166,4897,269,5.20
TX,Lampasas,8963,8483,480,5.40
TX,La Salle,3703,3454,249,6.70
TX,Lavaca,8341,7905,436,5.20
TX,Lee,9086,8637,449,4.90
TX,Leon,6043,5571,472,7.80
TX,Liberty,34126,30560,3566,10.40
TX,Limestone,8250,7662,588,7.10
TX,Lipscomb,1512,1449,63,4.20
TX,Live Oak,5121,4736,385,7.50
TX,Llano,8393,7911,482,5.70
TX,Loving,295,290,5,1.70
TX,Lubbock,155803,146854,8949,5.70
TX,Lynn,2722,2573,149,5.50
TX,McCulloch,3186,2946,240,7.50
TX,McLennan,118391,111020,7371,6.20
TX,McMullen,712,692,20,2.80
TX,Madison,4438,4120,318,7.20
TX,Marion,4204,3855,349,8.30
TX,Martin,2539,2384,155,6.10
TX,Mason,1714,1619,95,5.50
TX,Matagorda,16369,14647,1722,10.50
TX,Maverick,24103,20457,3646,15.10
TX,Medina,21192,19850,1342,6.30
TX,Menard,857,813,44,5.10
TX,Midland,97848,89972,7876,8.00
TX,Milam,9616,8926,690,7.20
TX,Mills,1865,1789,76,4.10
TX,Mitchell,2326,2142,184,7.90
TX,Montague,9001,8404,597,6.60
TX,Montgomery,288088,266622,21466,7.50
TX,Moore,10490,10098,392,3.70
TX,Morris,4821,4280,541,11.20
TX,Motley,429,410,19,4.40
TX,Nacogdoches,27645,25828,1817,6.60
TX,Navarro,23142,21711,1431,6.20
TX,Newton,4945,4394,551,11.10
TX,Nolan,7006,6631,375,5.40
TX,Nueces,163342,148793,14549,8.90
TX,Ochiltree,4000,3767,233,5.80
TX,Oldham,888,853,35,3.90
TX,Orange,35475,31720,3755,10.60
TX,Palo Pinto,13081,12161,920,7.00
TX,Panola,9338,8554,784,8.40
TX,Parker,69069,65054,4015,5.80
TX,Parmer,4814,4691,123,2.60
TX,Pecos,6361,5836,525,8.30
TX,Polk,18230,16625,1605,8.80
TX,Potter,52804,49882,2922,5.50
TX,Presidio,3175,2704,471,14.80
TX,Rains,5954,5674,280,4.70
TX,Randall,72526,69298,3228,4.50
TX,Reagan,1790,1615,175,9.80
TX,Real,1075,1005,70,6.50
TX,Red River,5069,4746,323,6.40
TX,Reeves,8740,8112,628,7.20
TX,Refugio,3022,2773,249,8.20
TX,Roberts,399,381,18,4.50
TX,Robertson,7257,6791,466,6.40
TX,Rockwall,54262,51050,3212,5.90
TX,Runnels,4495,4274,221,4.90
TX,Rusk,21800,20199,1601,7.30
TX,Sabine,3871,3452,419,10.80
TX,San Augustine,2999,2711,288,9.60
TX,San Jacinto,11529,10594,935,8.10
TX,San Patricio,29203,26222,2981,10.20
TX,San Saba,2174,2062,112,5.20
TX,Schleicher,1201,1118,83,6.90
TX,Scurry,6169,5661,508,8.20
TX,Shackelford,1763,1670,93,5.30
TX,Shelby,11138,10377,761,6.80
TX,Sherman,1295,1255,40,3.10
TX,Smith,107502,100209,7293,6.80
TX,Somervell,4240,3963,277,6.50
TX,Starr,25912,21375,4537,17.50
TX,Stephens,3995,3752,243,6.10
TX,Sterling,555,519,36,6.50
TX,Stonewall,568,539,29,5.10
TX,Sutton,1204,1085,119,9.90
TX,Swisher,2499,2369,130,5.20
TX,Tarrant,1070120,991029,79091,7.40
TX,Taylor,65565,61986,3579,5.50
TX,Terrell,377,360,17,4.50
TX,Terry,4771,4422,349,7.30
TX,Throckmorton,633,603,30,4.70
TX,Titus,13153,12268,885,6.70
TX,Tom Green,53310,49931,3379,6.30
TX,Travis,730591,684165,46426,6.40
TX,Trinity,5264,4836,428,8.10
TX,Tyler,7296,6575,721,9.90
TX,Upshur,17379,16041,1338,7.70
TX,Upton,1799,1696,103,5.70
TX,Uvalde,11208,10488,720,6.40
TX,Val Verde,21356,19576,1780,8.30
TX,Van Zandt,25874,24284,1590,6.10
TX,Victoria,40595,37217,3378,8.30
TX,Walker,23861,22148,1713,7.20
TX,Waller,24252,22406,1846,7.60
TX,Ward,6111,5532,579,9.50
TX,Washington,15102,14249,853,5.60
TX,Webb,115186,105441,9745,8.50
TX,Wharton,21161,19724,1437,6.80
TX,Wheeler,2174,2042,132,6.10
TX,Wichita,55057,51404,3653,6.60
TX,Wilbarger,4869,4584,285,5.90
TX,Willacy,6550,5766,784,12.00
TX,Williamson,321374,302663,18711,5.80
TX,Wilson,24248,22860,1388,5.70
TX,Winkler,3941,3569,372,9.40
TX,Wise,31929,29841,2088,6.50
TX,Wood,17724,16551,1173,6.60
TX,Yoakum,3484,3066,418,12.00
TX,Young,7686,7280,406,5.30
TX,Zapata,4640,4072,568,12.20
TX,Zavala,3370,2889,481,14.30
UT,Beaver,2838,2724,114,4.00
UT,Box Elder,26641,25470,1171,4.40
UT,Cache,65906,63958,1948,3.00
UT,Carbon,8600,8146,454,5.30
UT,Daggett,412,393,19,4.60
UT,Davis,176223,168939,7284,4.10
UT,Duchesne,7829,7218,611,7.80
UT,Emery,4404,4193,211,4.80
UT,Garfield,2654,2379,275,10.40
UT,Grand,6242,5647,595,9.50
UT,Iron,25272,24126,1146,4.50
UT,Juab,5847,5671,176,3.00
UT,Kane,3876,3669,207,5.30
UT,Millard,6029,5833,196,3.30
UT,Morgan,5664,5473,191,3.40
UT,Piute,481,451,30,6.20
UT,Rich,1164,1123,41,3.50
UT,Salt Lake,643461,610521,32940,5.10
UT,San Juan,5492,4928,564,10.30
UT,Sanpete,12759,12275,484,3.80
UT,Sevier,9901,9477,424,4.30
UT,Summit,24610,22837,1773,7.20
UT,Tooele,36054,34351,1703,4.70
UT,Uintah,13462,12212,1250,9.30
UT,Utah,316642,304605,12037,3.80
UT,Wasatch,16460,15398,1062,6.50
UT,Washington,80053,75746,4307,5.40
UT,Wayne,1449,1338,111,7.70
UT,Weber,130007,123701,6306,4.90
VT,Addison,20531,19588,943,4.60
VT,Bennington,17735,16580,1155,6.50
VT,Caledonia,14571,13698,873,6.00
VT,Chittenden,96193,91705,4488,4.70
VT,Essex,2714,2507,207,7.60
VT,Franklin,27373,25978,1395,5.10
VT,Grand Isle,4085,3847,238,5.80
VT,Lamoille,13914,12838,1076,7.70
VT,Orange,15890,15054,836,5.30
VT,Orleans,13118,12105,1013,7.70
VT,Rutland,30306,28274,2032,6.70
VT,Washington,34017,32354,1663,4.90
VT,Windham,21680,20239,1441,6.60
VT,Windsor,29011,27312,1699,5.90
VA,Accomack,16025,14987,1038,6.50
VA,Albemarle,56485,53473,3012,5.30
VA,Alleghany,6810,6367,443,6.50
VA,Amelia,6132,5777,355,5.80
VA,Amherst,14763,13944,819,5.50
VA,Appomattox,7121,6713,408,5.70
VA,Arlington,152550,145804,6746,4.40
VA,Augusta,37173,35471,1702,4.60
VA,Bath,2309,2080,229,9.90
VA,Bedford,38220,36284,1936,5.10
VA,Bland,2811,2653,158,5.60
VA,Botetourt,17321,16543,778,4.50
VA,Brunswick,5951,5481,470,7.90
VA,Buchanan,6430,5823,607,9.40
VA,Buckingham,6326,5863,463,7.30
VA,Campbell,25759,24261,1498,5.80
VA,Caroline,15029,14024,1005,6.70
VA,Carroll,13195,12116,1079,8.20
VA,Charles City,3534,3300,234,6.60
VA,Charlotte,5113,4830,283,5.50
VA,Chesterfield,188369,177388,10981,5.80
VA,Clarke,7479,7138,341,4.60
VA,Craig,2273,2157,116,5.10
VA,Culpeper,24876,23655,1221,4.90
VA,Cumberland,4603,4325,278,6.00
VA,Dickenson,4747,4372,375,7.90
VA,Dinwiddie,13469,12615,854,6.30
VA,Essex,5488,5109,379,6.90
VA,Fairfax,627997,591622,36375,5.80
VA,Fauquier,36777,35058,1719,4.70
VA,Floyd,8144,7735,409,5.00
VA,Fluvanna,13805,13083,722,5.20
VA,Franklin,26146,24731,1415,5.40
VA,Frederick,49464,47189,2275,4.60
VA,Giles,7788,7304,484,6.20
VA,Gloucester,19302,18257,1045,5.40
VA,Goochland,11426,10880,546,4.80
VA,Grayson,8022,7563,459,5.70
VA,Greene,10361,9824,537,5.20
VA,Greensville,4258,3975,283,6.60
VA,Halifax,15176,14114,1062,7.00
VA,Hanover,58056,55260,2796,4.80
VA,Henrico,181386,169700,11686,6.40
VA,Henry,23761,21957,1804,7.60
VA,Highland,1233,1187,46,3.70
VA,Isle of Wight,19391,18417,974,5.00
VA,James City,37050,34511,2539,6.90
VA,King and Queen,3878,3682,196,5.10
VA,King George,13882,13263,619,4.50
VA,King William,9297,8804,493,5.30
VA,Lancaster,5360,4971,389,7.30
VA,Lee,8301,7772,529,6.40
VA,Loudoun,227250,215250,12000,5.30
VA,Louisa,20011,18973,1038,5.20
VA,Lunenburg,5254,4979,275,5.20
VA,Madison,7336,7058,278,3.80
VA,Mathews,4019,3821,198,4.90
VA,Mecklenburg,12674,11818,856,6.80
VA,Middlesex,5154,4893,261,5.10
VA,Montgomery,49092,46761,2331,4.70
VA,Nelson,7229,6822,407,5.60
VA,New Kent,12767,12190,577,4.50
VA,Northampton,5418,4998,420,7.80
VA,Northumberland,5663,5304,359,6.30
VA,Nottoway,7204,6841,363,5.00
VA,Orange,17148,16186,962,5.60
VA,Page,12022,11143,879,7.30
VA,Patrick,7236,6743,493,6.80
VA,Pittsylvania,29972,28049,1923,6.40
VA,Powhatan,14172,13491,681,4.80
VA,Prince Edward,10144,9494,650,6.40
VA,Prince George,14981,14016,965,6.40
VA,Prince William,247678,231644,16034,6.50
VA,Pulaski,16208,14938,1270,7.80
VA,Rappahannock,3626,3461,165,4.60
VA,Richmond,4040,3844,196,4.90
VA,Roanoke,49086,46600,2486,5.10
VA,Rockbridge,10438,9866,572,5.50
VA,Rockingham,41777,39820,1957,4.70
VA,Russell,11193,10453,740,6.60
VA,Scott,9003,8522,481,5.30
VA,Shenandoah,22175,21008,1167,5.30
VA,Smyth,13425,12562,863,6.40
VA,Southampton,9094,8649,445,4.90
VA,Spotsylvania,68029,63987,4042,5.90
VA,Stafford,73839,69723,4116,5.60
VA,Surry,3603,3398,205,5.70
VA,Sussex,3689,3373,316,8.60
VA,Tazewell,15510,14328,1182,7.60
VA,Warren,20346,19165,1181,5.80
VA,Washington,25974,24474,1500,5.80
VA,Westmoreland,9527,8972,555,5.80
VA,Wise,13125,12138,987,7.50
VA,Wythe,13859,12790,1069,7.70
VA,York,32801,30991,1810,5.50
VA,Alexandria city,99382,93425,5957,6.00
VA,Bristol city,7558,6988,570,7.50
VA,Buena Vista city,3200,3022,178,5.60
VA,Charlottesville city,25278,23641,1637,6.50
VA,Chesapeake city,123014,115546,7468,6.10
VA,Colonial Heights city,8382,7783,599,7.10
VA,Covington city,2414,2182,232,9.60
VA,Danville city,19244,17386,1858,9.70
VA,Emporia city,2347,2090,257,11.00
VA,Fairfax city,12696,11962,734,5.80
VA,Falls Church city,8264,7951,313,3.80
VA,Franklin city,3647,3343,304,8.30
VA,Fredericksburg city,14179,13175,1004,7.10
VA,Galax city,2884,2661,223,7.70
VA,Hampton city,64985,59493,5492,8.50
VA,Harrisonburg city,24374,22818,1556,6.40
VA,Hopewell city,9723,8676,1047,10.80
VA,Lexington city,2043,1902,141,6.90
VA,Lynchburg city,35861,33263,2598,7.20
VA,Manassas city,21506,20102,1404,6.50
VA,Manassas Park city,9716,9071,645,6.60
VA,Martinsville city,5649,5034,615,10.90
VA,Newport News city,89574,81831,7743,8.60
VA,Norfolk city,111753,102070,9683,8.70
VA,Norton city,1661,1539,122,7.30
VA,Petersburg city,13071,11221,1850,14.20
VA,Poquoson city,6241,5980,261,4.20
VA,Portsmouth city,44953,40715,4238,9.40
VA,Radford city,8546,8010,536,6.30
VA,Richmond city,120511,109953,10558,8.80
VA,Roanoke city,49330,45554,3776,7.70
VA,Salem city,12745,12010,735,5.80
VA,Staunton city,12253,11483,770,6.30
VA,Suffolk city,45344,42448,2896,6.40
VA,Virginia Beach city,230879,216547,14332,6.20
VA,Waynesboro city,10650,9949,701,6.60
VA,Williamsburg city,6831,6277,554,8.10
VA,Winchester city,14688,13818,870,5.90
WA,Adams,9267,8599,668,7.20
WA,Asotin,10331,9799,532,5.10
WA,Benton,105564,97191,8373,7.90
WA,Chelan,44686,41025,3661,8.20
WA,Clallam,28904,25951,2953,10.20
WA,Clark,243828,223280,20548,8.40
WA,Columbia,1786,1661,125,7.00
WA,Cowlitz,48928,44453,4475,9.10
WA,Douglas,21571,19783,1788,8.30
WA,Ferry,2432,2151,281,11.60
WA,Franklin,43838,40032,3806,8.70
WA,Garfield,815,746,69,8.50
WA,Grant,46989,42845,4144,8.80
WA,Grays Harbor,28733,25357,3376,11.70
WA,Island,36239,33268,2971,8.20
WA,Jefferson,12908,11686,1222,9.50
WA,King,1278594,1178362,100232,7.80
WA,Kitsap,128417,118545,9872,7.70
WA,Kittitas,22318,20321,1997,8.90
WA,Klickitat,9738,8941,797,8.20
WA,Lewis,34813,31557,3256,9.40
WA,Lincoln,4680,4367,313,6.70
WA,Mason,25435,22935,2500,9.80
WA,Okanogan,19464,17729,1735,8.90
WA,Pacific,8296,7385,911,11.00
WA,Pend Oreille,5175,4652,523,10.10
WA,Pierce,453641,410559,43082,9.50
WA,San Juan,8126,7467,659,8.10
WA,Skagit,63553,57472,6081,9.60
WA,Skamania,5457,4956,501,9.20
WA,Snohomish,438858,400158,38700,8.80
WA,Spokane,264531,242217,22314,8.40
WA,Stevens,19102,17374,1728,9.00
WA,Thurston,147482,135613,11869,8.00
WA,Wahkiakum,1394,1273,121,8.70
WA,Walla Walla,31044,28997,2047,6.60
WA,Whatcom,116973,106333,10640,9.10
WA,Whitman,22190,20921,1269,5.70
WA,Yakima,133379,120855,12524,9.40
WV,Barbour,7196,6611,585,8.10
WV,Berkeley,58110,54586,3524,6.10
WV,Boone,7361,6606,755,10.30
WV,Braxton,5195,4672,523,10.10
WV,Brooke,9752,8899,853,8.70
WV,Cabell,41429,38200,3229,7.80
WV,Calhoun,2491,2099,392,15.70
WV,Clay,3105,2723,382,12.30
WV,Doddridge,3901,3668,233,6.00
WV,Fayette,16014,14449,1565,9.80
WV,Gilmer,2294,2066,228,9.90
WV,Grant,5914,5539,375,6.30
WV,Greenbrier,15538,14316,1222,7.90
WV,Hampshire,10649,10076,573,5.40
WV,Hancock,12982,11712,1270,9.80
WV,Hardy,5746,5341,405,7.00
WV,Harrison,33700,31085,2615,7.80
WV,Jackson,12502,11444,1058,8.50
WV,Jefferson,29674,27945,1729,5.80
WV,Kanawha,82265,75166,7099,8.60
WV,Lewis,6201,5538,663,10.70
WV,Lincoln,7105,6404,701,9.90
WV,Logan,11063,9752,1311,11.90
WV,McDowell,4408,3869,539,12.20
WV,Marion,24922,22801,2121,8.50
WV,Marshall,13373,12071,1302,9.70
WV,Mason,10245,9397,848,8.30
WV,Mercer,20745,18854,1891,9.10
WV,Mineral,12071,11178,893,7.40
WV,Mingo,6722,5779,943,14.00
WV,Monongalia,54222,50857,3365,6.20
WV,Monroe,5994,5578,416,6.90
WV,Morgan,8241,7752,489,5.90
WV,Nicholas,9281,8328,953,10.30
WV,Ohio,20250,18585,1665,8.20
WV,Pendleton,3635,3460,175,4.80
WV,Pleasants,2677,2384,293,10.90
WV,Pocahontas,3797,3455,342,9.00
WV,Preston,15234,14140,1094,7.20
WV,Putnam,26841,24901,1940,7.20
WV,Raleigh,30123,27493,2630,8.70
WV,Randolph,12184,11091,1093,9.00
WV,Ritchie,4352,3996,356,8.20
WV,Roane,5085,4470,615,12.10
WV,Summers,4337,4007,330,7.60
WV,Taylor,7724,7167,557,7.20
WV,Tucker,3306,3036,270,8.20
WV,Tyler,3012,2697,315,10.50
WV,Upshur,9564,8671,893,9.30
WV,Wayne,15570,14287,1283,8.20
WV,Webster,3265,2965,300,9.20
WV,Wetzel,6497,5858,639,9.80
WV,Wirt,2232,1996,236,10.60
WV,Wood,36102,32991,3111,8.60
WV,Wyoming,6829,6164,665,9.70
WI,Adams,8138,7354,784,9.60
WI,Ashland,7700,7037,663,8.60
WI,Barron,24170,22692,1478,6.10
WI,Bayfield,7569,6871,698,9.20
WI,Brown,141840,133226,8614,6.10
WI,Buffalo,6419,5941,478,7.40
WI,Burnett,7270,6610,660,9.10
WI,Calumet,27404,26108,1296,4.70
WI,Chippewa,33248,31163,2085,6.30
WI,Clark,17630,16830,800,4.50
WI,Columbia,31532,29655,1877,6.00
WI,Crawford,7457,6907,550,7.40
WI,Dane,324532,308816,15716,4.80
WI,Dodge,47884,45349,2535,5.30
WI,Door,15125,14089,1036,6.80
WI,Douglas,23453,21315,2138,9.10
WI,Dunn,23890,22559,1331,5.60
WI,Eau Claire,59026,55713,3313,5.60
WI,Florence,2209,2032,177,8.00
WI,Fond du Lac,56385,53054,3331,5.90
WI,Forest,3934,3437,497,12.60
WI,Grant,27619,26171,1448,5.20
WI,Green,20491,19488,1003,4.90
WI,Green Lake,9328,8686,642,6.90
WI,Iowa,13568,12733,835,6.20
WI,Iron,2578,2285,293,11.40
WI,Jackson,10020,9085,935,9.30
WI,Jefferson,45622,43114,2508,5.50
WI,Juneau,13459,12485,974,7.20
WI,Kenosha,90015,83601,6414,7.10
WI,Kewaunee,10744,10247,497,4.60
WI,La Crosse,66060,62474,3586,5.40
WI,Lafayette,9924,9498,426,4.30
WI,Langlade,9402,8789,613,6.50
WI,Lincoln,14875,13990,885,5.90
WI,Manitowoc,40918,38371,2547,6.20
WI,Marathon,73260,69592,3668,5.00
WI,Marinette,19762,18215,1547,7.80
WI,Marquette,7758,7235,523,6.70
WI,Menominee,1666,1407,259,15.50
WI,Milwaukee,468910,429967,38943,8.30
WI,Monroe,23640,22318,1322,5.60
WI,Oconto,20670,19369,1301,6.30
WI,Oneida,18086,16774,1312,7.30
WI,Outagamie,104152,98393,5759,5.50
WI,Ozaukee,48975,46310,2665,5.40
WI,Pepin,4140,3897,243,5.90
WI,Pierce,25010,23256,1754,7.00
WI,Polk,24772,22992,1780,7.20
WI,Portage,37941,35883,2058,5.40
WI,Price,6289,5860,429,6.80
WI,Racine,98515,91314,7201,7.30
WI,Richland,9129,8661,468,5.10
WI,Rock,85964,79829,6135,7.10
WI,Rusk,6623,6181,442,6.70
WI,St. Croix,50854,47270,3584,7.00
WI,Sauk,34747,32125,2622,7.50
WI,Sawyer,8027,7393,634,7.90
WI,Shawano,20976,19627,1349,6.40
WI,Sheboygan,62077,58505,3572,5.80
WI,Taylor,11097,10555,542,4.90
WI,Trempealeau,15801,14690,1111,7.00
WI,Vernon,15096,14305,791,5.20
WI,Vilas,10419,9667,752,7.20
WI,Walworth,57061,53583,3478,6.10
WI,Washburn,7878,7334,544,6.90
WI,Washington,76822,72478,4344,5.70
WI,Waukesha,224176,211634,12542,5.60
WI,Waupaca,25800,24368,1432,5.60
WI,Waushara,11116,10404,712,6.40
WI,Winnebago,92380,87328,5052,5.50
WI,Wood,34855,32511,2344,6.70
WY,Albany,20572,19810,762,3.70
WY,Big Horn,5293,5028,265,5.00
WY,Campbell,23166,21591,1575,6.80
WY,Carbon,7925,7562,363,4.60
WY,Converse,8000,7528,472,5.90
WY,Crook,3841,3693,148,3.90
WY,Fremont,19017,17833,1184,6.20
WY,Goshen,6505,6225,280,4.30
WY,Hot Springs,2229,2119,110,4.90
WY,Johnson,4173,3944,229,5.50
WY,Laramie,50114,47565,2549,5.10
WY,Lincoln,9294,8831,463,5.00
WY,Natrona,40081,36982,3099,7.70
WY,Niobrara,1233,1188,45,3.60
WY,Park,15203,14385,818,5.40
WY,Platte,4580,4351,229,5.00
WY,Sheridan,16002,15210,792,4.90
WY,Sublette,4020,3730,290,7.20
WY,Sweetwater,20503,18998,1505,7.30
WY,Teton,15138,14251,887,5.90
WY,Uinta,9102,8532,570,6.30
WY,Washakie,3945,3739,206,5.20
WY,Weston,3789,3645,144,3.80
